State Label,State type,State,Age-group,District code,State (Acceptable Performance),State (Under Performance),State code,Table name,Total/rural/urban,Under Performance/Acceptable Performance,Main workers %,Main workers - females,Main workers - males,Main workers - population,Marginal workers seeking work - females,Marginal workers seeking work - males,Marginal workers seeking work - population,Marginal workers worked for 3 to 6 months - females,Marginal workers worked for 3 to 6 months - males,Marginal workers worked for 3 to 6 months - population,Marginal workers worked less than 3 months - females,Marginal workers worked less than 3 months - males,Marginal workers worked less than 3 months - population,Non-workers %,Non-workers - females,Non-workers - males,Non-workers - population,Non-workers seeking work - females,Non-workers seeking work - males,Non-workers seeking work - population,Number of Records,State class,Total females,Total LFPR,Total males,Total population
Can be emulated,Above average state,KARNATAKA,15-19,0,KARNATAKA,AP,29,B0101,Rural,Acceptable Performance,0.254239169,315635,614439,930074,48168,67638,115806,150720,148794,299514,27445,30999,58444,0.647911687,1230655,1139577,2370232,124470,140539,265009,1,2,1724455,592,1933809,3658264
Can be emulated,Above average state,MAHARASHTRA,15-19,0,MAHARASHTRA,AP,27,B0101,Rural,Acceptable Performance,0.226403653,549962,803856,1353818,73257,109027,182284,151281,152864,304145,43702,46302,90004,0.70768145,2025496,2206202,4231698,173740,265275,439015,1,2,2770441,596,3209224,5979665
Can be emulated,Above average state,KARNATAKA,15-59,0,KARNATAKA,AP,29,B0101,Rural,Acceptable Performance,0.571332671,4551053,8815188,13366241,374647,404659,779306,1694887,998322,2693209,194126,133950,328076,0.299524152,5087752,1919570,7007322,444957,351259,796216,1,2,11527818,592,11867030,23394848
Can be emulated,Above average state,MAHARASHTRA,15-59,0,MAHARASHTRA,AP,27,B0101,Rural,Acceptable Performance,0.61977755,8969490,13997065,22966555,677060,812689,1489749,1782734,1214866,2997600,276713,189574,466287,0.286745679,6964364,3661320,10625684,612035,679302,1291337,1,2,17993301,596,19062825,37056126
Can be emulated,Above average state,KARNATAKA,20-24,0,KARNATAKA,AP,29,B0101,Rural,Acceptable Performance,0.493598541,557918,1194073,1751991,70150,103874,174024,235462,202237,437699,30470,28917,59387,0.36635455,875991,424357,1300348,139407,134870,274277,1,2,1699841,592,1849584,3549425
Can be emulated,Above average state,MAHARASHTRA,20-24,0,MAHARASHTRA,AP,27,B0101,Rural,Acceptable Performance,0.528825064,1193492,1855102,3048594,123951,191920,315871,270187,241715,511902,46682,42738,89420,0.366866475,1236284,878644,2114928,189356,272037,461393,1,2,2746645,596,3018199,5764844
Can be emulated,Above average state,KARNATAKA,25-29,0,KARNATAKA,AP,29,B0101,Rural,Acceptable Performance,0.609417428,666889,1334138,2001027,65013,76762,141775,258135,167055,425190,28318,20113,48431,0.246340195,684679,124181,808860,77683,46025,123708,1,2,1638021,592,1645487,3283508
Can be emulated,Above average state,MAHARASHTRA,25-29,0,MAHARASHTRA,AP,27,B0101,Rural,Acceptable Performance,0.683309063,1287921,2145897,3433818,107622,143230,250852,259423,195440,454863,37605,25406,63011,0.213637136,850977,222609,1073586,99838,86864,186702,1,2,2435926,596,2589352,5025278
Can be emulated,Above average state,KARNATAKA,30-34,0,KARNATAKA,AP,29,B0101,Rural,Acceptable Performance,0.663968644,610438,1154224,1764662,47222,45352,92574,220159,115728,335887,22596,13047,35643,0.196240127,472159,49398,521557,33229,12873,46102,1,2,1325352,592,1332397,2657749
Can be emulated,Above average state,MAHARASHTRA,30-34,0,MAHARASHTRA,AP,27,B0101,Rural,Acceptable Performance,0.739349577,1271635,1977955,3249590,93469,99962,193431,240160,147965,388125,31255,16982,48237,0.161368957,633394,75855,709249,51472,22342,73814,1,2,2176444,596,2218757,4395201
Can be emulated,Above average state,KARNATAKA,35-39,0,KARNATAKA,AP,29,B0101,Rural,Acceptable Performance,0.682028742,706053,1183820,1889873,48427,38173,86600,243969,106111,350080,23869,11787,35656,0.178764528,459428,35921,495349,26236,6893,33129,1,2,1433319,592,1337639,2770958
Can be emulated,Above average state,MAHARASHTRA,35-39,0,MAHARASHTRA,AP,27,B0101,Rural,Acceptable Performance,0.760532913,1298369,1913633,3212002,87723,84942,172665,235486,131508,366994,29359,14965,44324,0.142075842,548868,51169,600037,36482,11135,47617,1,2,2112082,596,2111275,4223357
Can be emulated,Above average state,KARNATAKA,40-49,0,KARNATAKA,AP,29,B0101,Rural,Acceptable Performance,0.694051156,1068264,2045271,3113535,63002,49577,112579,365400,162259,527659,35828,17850,53678,0.176360574,729294,61865,791159,28457,6616,35073,1,2,2198786,592,2287245,4486031
Can be emulated,Above average state,MAHARASHTRA,40-49,0,MAHARASHTRA,AP,27,B0101,Rural,Acceptable Performance,0.763276334,2080181,3209856,5290037,125667,120563,246230,379522,207878,587400,48664,24175,72839,0.141460664,890237,90184,980421,39804,13103,52907,1,2,3398604,596,3532093,6930697
Can be emulated,Above average state,KARNATAKA,5-Sep,0,KARNATAKA,AP,29,B0101,Rural,Acceptable Performance,0.009174168,13949,16414,30363,1517,1544,3061,7546,7465,15011,2809,3023,5832,0.984528128,1584698,1673715,3258413,7294,7908,15202,1,2,1609002,592,1700617,3309619
Can be emulated,Above average state,MAHARASHTRA,5-Sep,0,MAHARASHTRA,AP,27,B0101,Rural,Acceptable Performance,0.016911793,44380,51182,95562,2444,2836,5280,13274,14306,27580,4313,4433,8746,0.976659523,2616779,2901946,5518725,12819,14280,27099,1,2,2678746,596,2971867,5650613
Can be emulated,Above average state,KARNATAKA,50-59,0,KARNATAKA,AP,29,B0101,Rural,Acceptable Performance,0.640727582,625856,1289223,1915079,32665,23283,55948,221042,96138,317180,25600,11237,36837,0.240829024,635546,84271,719817,15475,3443,18918,1,2,1508044,592,1480869,2988913
Can be emulated,Above average state,MAHARASHTRA,50-59,0,MAHARASHTRA,AP,27,B0101,Rural,Acceptable Performance,0.713243844,1287930,2090766,3378696,65371,63045,128416,246675,137496,384171,39446,19006,58452,0.193318295,779108,136657,915765,21343,8546,29889,1,2,2353159,596,2383925,4737084
Can be emulated,Above average state,KARNATAKA,60-69,0,KARNATAKA,AP,29,B0101,Rural,Acceptable Performance,0.473678753,336367,796548,1132915,16123,13860,29983,124328,72026,196354,19498,10854,30352,0.431534069,777406,254710,1032116,10970,4202,15172,1,2,1257599,592,1134138,2391737
Can be emulated,Above average state,MAHARASHTRA,60-69,0,MAHARASHTRA,AP,27,B0101,Rural,Acceptable Performance,0.540748825,901760,1350056,2251816,39441,35607,75048,180919,111044,291963,42015,22481,64496,0.373651469,1148662,407318,1555980,20693,9927,30620,1,2,2273356,596,1890899,4164255
Can be emulated,Above average state,KARNATAKA,60+,0,KARNATAKA,AP,29,B0101,Rural,Acceptable Performance,0.388431665,427779,1085966,1513745,20088,18540,38628,157750,103041,260791,26889,17504,44393,0.533257174,1452518,625622,2078140,15609,6583,22192,1,2,2064936,592,1832133,3897069
Can be emulated,Above average state,MAHARASHTRA,60+,0,MAHARASHTRA,AP,27,B0101,Rural,Acceptable Performance,0.447402124,1162526,1955661,3118187,49953,49444,99397,237242,172329,409571,61423,41488,102911,0.479066194,2269257,1069614,3338871,30081,16234,46315,1,2,3730448,596,3239092,6969540
Can be emulated,Above average state,KARNATAKA,70-79,0,KARNATAKA,AP,29,B0101,Rural,Acceptable Performance,0.28818569,73070,240006,313076,3089,3689,6778,26708,25113,51821,5954,5198,11152,0.653847818,462037,248283,710320,3682,1836,5518,1,2,567769,592,518600,1086369
Can be emulated,Above average state,MAHARASHTRA,70-79,0,MAHARASHTRA,AP,27,B0101,Rural,Acceptable Performance,0.344877318,212229,503717,715946,8473,11186,19659,46322,50296,96618,15960,15073,31033,0.593632102,792488,439859,1232347,7523,4635,12158,1,2,1066999,596,1008945,2075944
Can be emulated,Above average state,KARNATAKA,80+,0,KARNATAKA,AP,29,B0101,Rural,Acceptable Performance,0.161718338,18342,49412,67754,876,991,1867,6714,5902,12616,1437,1452,2889,0.801273621,213075,122629,335704,957,545,1502,1,2,239568,592,179395,418963
Can be emulated,Above average state,MAHARASHTRA,80+,0,MAHARASHTRA,AP,27,B0101,Rural,Acceptable Performance,0.206247832,48537,101888,150425,2039,2651,4690,10001,10989,20990,3448,3934,7382,0.754851297,328107,222437,550544,1865,1672,3537,1,2,390093,596,339248,729341
Can be emulated,Above average state,KARNATAKA,Age not stated,0,KARNATAKA,AP,29,B0101,Rural,Acceptable Performance,0.250222618,2129,4334,6463,146,176,322,843,683,1526,102,84,186,0.683495296,8802,8852,17654,179,200,379,1,2,11876,592,13953,25829
Can be emulated,Above average state,MAHARASHTRA,Age not stated,0,MAHARASHTRA,AP,27,B0101,Rural,Acceptable Performance,0.41636195,32870,52871,85741,2291,2715,5006,7415,5603,13018,1045,852,1897,0.511210174,55876,49397,105273,1338,1552,2890,1,2,97206,596,108723,205929
Can be emulated,Above average state,KARNATAKA,Oct-14,0,KARNATAKA,AP,29,B0101,Rural,Acceptable Performance,0.039343067,62974,81119,144093,8445,8674,17119,35150,30861,66011,12818,13472,26290,0.935455123,1661808,1764273,3426081,16448,17931,34379,1,2,1772750,592,1889725,3662475
Can be emulated,Above average state,MAHARASHTRA,Oct-14,0,MAHARASHTRA,AP,27,B0101,Rural,Acceptable Performance,0.039005559,112103,131918,244021,11149,12819,23968,37898,35397,73295,20374,19526,39900,0.942900776,2797526,3101315,5898841,25266,31410,56676,1,2,2967901,596,3288156,6256057
Can be emulated,Above average state,KARNATAKA,Total,0,KARNATAKA,AP,29,B0101,Rural,Acceptable Performance,0.401952824,5057884,10003021,15060905,404843,433593,838436,1896176,1140372,3036548,236744,168033,404777,0.506203406,11349177,7617928,18967105,484487,383881,868368,1,2,18539981,592,18929354,37469335
Can be emulated,Above average state,MAHARASHTRA,Total,0,MAHARASHTRA,AP,27,B0101,Rural,Acceptable Performance,0.430665315,10321369,16188697,26510066,742897,880503,1623400,2078563,1442501,3521064,363868,255873,619741,0.502065856,17253240,13651963,30905203,681539,742778,1424317,1,2,30017040,596,31539034,61556074
Not considered,Above average state,ANDAMAN & NICOBAR ISLANDS,15-19,0,ANDAMAN & NICOBAR ISLANDS,AP,35,B0101,Rural,Acceptable Performance,0.076979724,314,1254,1568,247,569,816,293,579,872,120,252,372,0.861947076,8998,8559,17557,2345,2279,4624,1,2,9725,593,10644,20369
Not considered,Above average state,ANDHRA PRADESH,15-19,0,ANDHRA PRADESH,AP,28,B0101,Rural,Acceptable Performance,0.259288172,597333,785728,1383061,114400,115131,229531,188211,160598,348809,42287,38478,80765,0.660177812,1706245,1815189,3521434,200594,223803,424397,1,1,2534076,635,2799993,5334069
Not considered,Above average state,CHHATTISGARH,15-19,0,CHHATTISGARH,AP,22,B0101,Rural,Acceptable Performance,0.180176582,145577,214425,360002,118345,126015,244360,173241,144825,318066,76869,67199,144068,0.588531023,593030,582885,1175915,67111,76944,144055,1,1,988717,660,1009334,1998051
Not considered,Above average state,DAMAN & DIU,15-19,0,DAMAN & DIU,AP,25,B0101,Rural,Acceptable Performance,0.253193088,263,1422,1685,16,24,40,60,63,123,14,37,51,0.720661157,2552,2244,4796,350,300,650,1,2,2889,588,3766,6655
Not considered,Above average state,GUJARAT,15-19,0,GUJARAT,AP,24,B0101,Rural,Acceptable Performance,0.228199689,218090,559280,777370,66546,90869,157415,240262,163686,403948,43062,33755,76817,0.630670059,1123546,1024853,2148399,75898,101944,177842,1,1,1624960,603,1781574,3406534
Not considered,Above average state,MEGHALAYA,15-19,0,MEGHALAYA,AP,17,B0101,Rural,Acceptable Performance,0.208686824,20599,32435,53034,5595,7716,13311,11100,12805,23905,4744,5332,10076,0.6575992,88551,78566,167117,15686,14564,30250,1,1,124994,660,129138,254132
Not considered,Above average state,MIZORAM,15-19,0,MIZORAM,AP,15,B0101,Rural,Acceptable Performance,0.302226556,6422,8767,15189,813,781,1594,1892,1286,3178,1037,909,1946,0.595817498,14906,15038,29944,2057,2198,4255,1,1,24257,657,26000,50257
Not considered,Above average state,RAJASTHAN,15-19,0,RAJASTHAN,AP,8,B0101,Rural,Acceptable Performance,0.19102609,400456,649602,1050058,249233,271622,520855,478844,324157,803001,191728,167659,359387,0.597512796,1507824,1776665,3284489,192520,278619,471139,1,2,2578852,569,2918083,5496935
Not considered,Above average state,TAMIL NADU,15-19,0,TAMIL NADU,AP,33,B0101,Rural,Acceptable Performance,0.185072595,240305,383963,624268,38986,52849,91835,78957,93734,172691,14286,16297,30583,0.75466411,1274317,1271239,2545556,186631,221822,408453,1,1,1607865,610,1765233,3373098
Not considered,Above average state,TRIPURA,15-19,0,TRIPURA,AP,16,B0101,Rural,Acceptable Performance,0.099567824,6806,20564,27370,10823,13639,24462,11629,12721,24350,4156,4665,8821,0.779761212,112920,101427,214347,37999,32854,70853,1,2,135511,582,139377,274888
Not considered,Above average state,ANDAMAN & NICOBAR ISLANDS,15-59,0,ANDAMAN & NICOBAR ISLANDS,AP,35,B0101,Rural,Acceptable Performance,0.422219163,11155,56319,67474,2662,7012,9674,5428,10305,15733,1752,2674,4426,0.451635713,55343,16832,72175,13600,6549,20149,1,2,73678,593,86130,159808
Not considered,Above average state,ANDHRA PRADESH,15-59,0,ANDHRA PRADESH,AP,28,B0101,Rural,Acceptable Performance,0.607839866,8551912,12781896,21333808,1175656,966030,2141686,2272552,1395626,3668178,330831,184158,514989,0.272973927,6358258,3222511,9580769,776927,648611,1425538,1,1,17513553,635,17584191,35097744
Not considered,Above average state,CHHATTISGARH,15-59,0,CHHATTISGARH,AP,22,B0101,Rural,Acceptable Performance,0.503559201,2069047,3707621,5776668,920229,844528,1764757,1656896,1016369,2673265,349363,177233,526596,0.21750501,1637300,857847,2495147,240001,173193,413194,1,1,5712606,660,5759070,11471676
Not considered,Above average state,DAMAN & DIU,15-59,0,DAMAN & DIU,AP,25,B0101,Rural,Acceptable Performance,0.518679982,3088,17376,20464,192,182,374,845,487,1332,178,148,326,0.439296396,13432,3900,17332,1360,900,2260,1,2,17543,588,21911,39454
Not considered,Above average state,GUJARAT,15-59,0,GUJARAT,AP,24,B0101,Rural,Acceptable Performance,0.512552404,2477270,8233636,10710906,406010,411049,817059,2173419,788759,2962178,200428,99448,299876,0.331347484,5293740,1630492,6924232,306528,229398,535926,1,1,10144857,603,10752335,20897192
Not considered,Above average state,MEGHALAYA,15-59,0,MEGHALAYA,AP,17,B0101,Rural,Acceptable Performance,0.521619601,248065,408423,656488,37401,38820,76221,94129,70404,164533,22527,17227,39754,0.316061966,262031,135751,397782,49741,30074,79815,1,1,626752,660,631805,1258557
Not considered,Above average state,MIZORAM,15-59,0,MIZORAM,AP,15,B0101,Rural,Acceptable Performance,0.660598664,76161,122483,198644,4615,3102,7717,16422,5496,21918,4137,1957,6094,0.246246296,49749,24298,74047,6124,4528,10652,1,1,146469,657,154234,300703
Not considered,Above average state,RAJASTHAN,15-59,0,RAJASTHAN,AP,8,B0101,Rural,Acceptable Performance,0.508422968,4622691,9983071,14605762,1694445,1437776,3132221,3911847,1802957,5714804,856000,397290,1253290,0.249019401,4486063,2667662,7153725,634187,610065,1244252,1,2,13876601,569,14850980,28727581
Not considered,Above average state,TAMIL NADU,15-59,0,TAMIL NADU,AP,33,B0101,Rural,Acceptable Performance,0.560062032,5144887,8346468,13491355,488517,582214,1070731,1377833,1229817,2607650,251177,178217,429394,0.313862194,5320220,2240418,7560638,822009,586493,1408502,1,1,12094117,610,11994920,24089037
Not considered,Above average state,TRIPURA,15-59,0,TRIPURA,AP,16,B0101,Rural,Acceptable Performance,0.415652371,127767,578103,705870,125009,94654,219663,141737,94101,235838,49784,22102,71886,0.403143994,506009,178619,684628,216034,78829,294863,1,2,825297,582,872925,1698222
Not considered,Above average state,ANDAMAN & NICOBAR ISLANDS,20-24,0,ANDAMAN & NICOBAR ISLANDS,AP,35,B0101,Rural,Acceptable Performance,0.291792369,941,5636,6577,498,1451,1949,686,1610,2296,235,524,759,0.572670807,9024,3884,12908,3727,2320,6047,1,2,10886,593,11654,22540
Not considered,Above average state,ANDHRA PRADESH,20-24,0,ANDHRA PRADESH,AP,28,B0101,Rural,Acceptable Performance,0.504709898,1089091,1567337,2656428,179579,175155,354734,310065,232730,542795,48087,34735,82822,0.376425561,1133364,847868,1981232,220030,257631,477661,1,1,2580607,635,2682670,5263277
Not considered,Above average state,CHHATTISGARH,20-24,0,CHHATTISGARH,AP,22,B0101,Rural,Acceptable Performance,0.431780528,284662,481286,765948,168688,180679,349367,270124,199159,469283,62464,39009,101473,0.24647266,271517,165708,437225,64449,62942,127391,1,1,888767,660,885162,1773929
Not considered,Above average state,DAMAN & DIU,20-24,0,DAMAN & DIU,AP,25,B0101,Rural,Acceptable Performance,0.494305239,385,3087,3472,41,44,85,115,98,213,27,46,73,0.464977221,2380,886,3266,401,352,753,1,2,2907,588,4117,7024
Not considered,Above average state,GUJARAT,20-24,0,GUJARAT,AP,24,B0101,Rural,Acceptable Performance,0.444789803,306294,1085504,1391798,79328,113038,192366,323855,191878,515733,35491,23781,59272,0.371450513,849713,312598,1162311,81193,78642,159835,1,1,1515353,603,1613761,3129114
Not considered,Above average state,MEGHALAYA,20-24,0,MEGHALAYA,AP,17,B0101,Rural,Acceptable Performance,0.430792628,37431,56328,93759,7920,8699,16619,16694,13814,30508,4409,3818,8227,0.391232431,53737,31412,85149,13654,9415,23069,1,1,112271,660,105372,217643
Not considered,Above average state,MIZORAM,20-24,0,MIZORAM,AP,15,B0101,Rural,Acceptable Performance,0.590044929,11720,18354,30074,1136,897,2033,3126,1295,4421,898,413,1311,0.297494556,9911,5252,15163,1758,1478,3236,1,1,25655,657,25314,50969
Not considered,Above average state,RAJASTHAN,20-24,0,RAJASTHAN,AP,8,B0101,Rural,Acceptable Performance,0.453181574,669718,1452423,2122141,302778,343074,645852,627482,385028,1012510,144188,90260,234448,0.280531507,769699,543963,1313662,166453,220554,387007,1,2,2211087,569,2471674,4682761
Not considered,Above average state,TAMIL NADU,20-24,0,TAMIL NADU,AP,33,B0101,Rural,Acceptable Performance,0.433747361,516034,921940,1437974,80708,109269,189977,157304,170184,327488,28500,26931,55431,0.450749781,954626,539715,1494341,249132,219655,468787,1,1,1656464,610,1658770,3315234
Not considered,Above average state,TRIPURA,20-24,0,TRIPURA,AP,16,B0101,Rural,Acceptable Performance,0.288415529,15159,65850,81009,21473,23803,45276,23131,22020,45151,7526,5998,13524,0.502684459,96594,44598,141192,52210,27096,79306,1,2,142410,582,138466,280876
Not considered,Above average state,ANDAMAN & NICOBAR ISLANDS,25-29,0,ANDAMAN & NICOBAR ISLANDS,AP,35,B0101,Rural,Acceptable Performance,0.43364113,1726,9357,11083,609,1699,2308,929,2104,3033,284,512,796,0.416542765,8944,1702,10646,3005,1079,4084,1,2,11883,593,13675,25558
Not considered,Above average state,ANDHRA PRADESH,25-29,0,ANDHRA PRADESH,AP,28,B0101,Rural,Acceptable Performance,0.663535032,1343861,1970882,3314743,197441,158743,356184,358699,219112,577811,48594,25067,73661,0.206055312,791285,238081,1029366,132584,102409,234993,1,1,2542439,635,2453142,4995581
Not considered,Above average state,CHHATTISGARH,25-29,0,CHHATTISGARH,AP,22,B0101,Rural,Acceptable Performance,0.556961295,285056,554943,839999,138229,137250,275479,239041,158504,397545,44007,19233,63240,0.137515234,169551,37847,207398,34898,17616,52514,1,1,737655,660,770527,1508182
Not considered,Above average state,DAMAN & DIU,25-29,0,DAMAN & DIU,AP,25,B0101,Rural,Acceptable Performance,0.558530612,404,3017,3421,34,40,74,116,92,208,28,17,45,0.400163265,2161,290,2451,234,147,381,1,2,2709,588,3416,6125
Not considered,Above average state,GUJARAT,25-29,0,GUJARAT,AP,24,B0101,Rural,Acceptable Performance,0.550306933,322207,1200790,1522997,65131,76500,141631,309386,137584,446970,25987,13383,39370,0.27396306,670558,87646,758204,49767,26380,76147,1,1,1328138,603,1439403,2767541
Not considered,Above average state,MEGHALAYA,25-29,0,MEGHALAYA,AP,17,B0101,Rural,Acceptable Performance,0.570544696,40679,68780,109459,6860,7274,14134,16404,12368,28772,3531,2526,6057,0.247912432,36272,11290,47562,8353,3415,11768,1,1,96886,660,94964,191850
Not considered,Above average state,MIZORAM,25-29,0,MIZORAM,AP,15,B0101,Rural,Acceptable Performance,0.702936357,12003,20602,32605,986,575,1561,3025,968,3993,689,207,896,0.191660918,7225,1665,8890,971,504,1475,1,1,22942,657,23442,46384
Not considered,Above average state,RAJASTHAN,25-29,0,RAJASTHAN,AP,8,B0101,Rural,Acceptable Performance,0.57748977,672855,1540486,2213341,259412,231368,490780,575984,277796,853780,110784,39942,150726,0.160421406,491217,123629,614846,88434,61805,150239,1,2,1850840,569,1981853,3832693
Not considered,Above average state,TAMIL NADU,25-29,0,TAMIL NADU,AP,33,B0101,Rural,Acceptable Performance,0.585948273,709460,1259618,1969078,91923,110589,202512,203256,189249,392505,36942,27350,64292,0.278120386,758342,176281,934623,174668,91094,265762,1,1,1708000,610,1652498,3360498
Not considered,Above average state,TRIPURA,25-29,0,TRIPURA,AP,16,B0101,Rural,Acceptable Performance,0.440852646,18602,92872,111474,22696,18664,41360,24163,18224,42387,8424,3869,12293,0.34290121,72282,14424,86706,39184,10089,49273,1,2,123471,582,129389,252860
Not considered,Above average state,ANDAMAN & NICOBAR ISLANDS,30-34,0,ANDAMAN & NICOBAR ISLANDS,AP,35,B0101,Rural,Acceptable Performance,0.499885379,1822,9081,10903,436,1186,1622,788,1656,2444,289,397,686,0.35660905,6967,811,7778,1900,423,2323,1,2,9866,593,11945,21811
Not considered,Above average state,ANDHRA PRADESH,30-34,0,ANDHRA PRADESH,AP,28,B0101,Rural,Acceptable Performance,0.721603904,1217076,1837920,3054996,166043,126150,292193,315716,178337,494053,40826,18568,59394,0.147669405,553086,72090,625176,66177,26223,92400,1,1,2126704,635,2106915,4233619
Not considered,Above average state,CHHATTISGARH,30-34,0,CHHATTISGARH,AP,22,B0101,Rural,Acceptable Performance,0.597601047,293523,507263,800786,124982,102293,227275,223111,121532,344643,36972,12405,49377,0.108354397,129939,15256,145195,22925,5957,28882,1,1,683545,660,656456,1340001
Not considered,Above average state,DAMAN & DIU,30-34,0,DAMAN & DIU,AP,25,B0101,Rural,Acceptable Performance,0.618475478,501,2639,3140,22,26,48,97,67,164,23,15,38,0.341737246,1633,102,1735,128,43,171,1,2,2254,588,2823,5077
Not considered,Above average state,GUJARAT,30-34,0,GUJARAT,AP,24,B0101,Rural,Acceptable Performance,0.593163192,352879,1170284,1523163,55487,46997,102484,306073,91177,397250,22403,8082,30485,0.240264578,577042,39925,616967,31915,8956,40871,1,1,1258397,603,1309468,2567865
Not considered,Above average state,MEGHALAYA,30-34,0,MEGHALAYA,AP,17,B0101,Rural,Acceptable Performance,0.639035598,33629,57601,91230,4611,4535,9146,12135,8257,20392,2382,1585,3967,0.190337765,22582,4591,27173,4324,1110,5434,1,1,70728,660,72034,142762
Not considered,Above average state,MIZORAM,30-34,0,MIZORAM,AP,15,B0101,Rural,Acceptable Performance,0.752710377,10818,18342,29160,591,316,907,2374,582,2956,461,111,572,0.15622096,5286,766,6052,578,173,751,1,1,18939,657,19801,38740
Not considered,Above average state,RAJASTHAN,30-34,0,RAJASTHAN,AP,8,B0101,Rural,Acceptable Performance,0.614198183,664350,1431796,2096146,235793,168521,404314,541429,210810,752239,97730,24943,122673,0.129441163,393197,48562,441759,59186,19286,78472,1,2,1696706,569,1716111,3412817
Not considered,Above average state,TAMIL NADU,30-34,0,TAMIL NADU,AP,33,B0101,Rural,Acceptable Performance,0.659472296,685247,1177906,1863153,68415,81208,149623,183563,159703,343266,33043,21671,54714,0.199660699,503853,60232,564085,79697,25754,105451,1,1,1405706,610,1419512,2825218
Not considered,Above average state,TRIPURA,30-34,0,TRIPURA,AP,16,B0101,Rural,Acceptable Performance,0.517713845,17973,88090,106063,18508,11971,30479,19991,12127,32118,7167,2121,9288,0.280175528,52006,5393,57399,27077,3627,30704,1,2,97137,582,107731,204868
Not considered,Above average state,ANDAMAN & NICOBAR ISLANDS,35-39,0,ANDAMAN & NICOBAR ISLANDS,AP,35,B0101,Rural,Acceptable Performance,0.517422483,1948,8298,10246,375,813,1188,833,1381,2214,240,300,540,0.343500656,6357,445,6802,1289,201,1490,1,2,9378,593,10424,19802
Not considered,Above average state,ANDHRA PRADESH,35-39,0,ANDHRA PRADESH,AP,28,B0101,Rural,Acceptable Performance,0.735385241,1291310,1831399,3122709,166677,119134,285811,325875,170732,496607,41009,17837,58846,0.133807842,523720,44476,568196,52909,12405,65314,1,1,2181914,635,2064444,4246358
Not considered,Above average state,CHHATTISGARH,35-39,0,CHHATTISGARH,AP,22,B0101,Rural,Acceptable Performance,0.625818404,304007,527966,831973,117623,93230,210853,217124,113947,331071,33856,10571,44427,0.091728248,111087,10858,121945,17110,3331,20441,1,1,666074,660,663342,1329416
Not considered,Above average state,DAMAN & DIU,35-39,0,DAMAN & DIU,AP,25,B0101,Rural,Acceptable Performance,0.638538774,508,2481,2989,30,15,45,137,41,178,27,8,35,0.315958129,1408,71,1479,117,26,143,1,2,2080,588,2601,4681
Not considered,Above average state,GUJARAT,35-39,0,GUJARAT,AP,24,B0101,Rural,Acceptable Performance,0.62394233,353638,1131268,1484906,46676,31739,78415,277998,65644,343642,18694,5804,24498,0.221369004,498731,28100,526831,23944,4907,28851,1,1,1149061,603,1230816,2379877
Not considered,Above average state,MEGHALAYA,35-39,0,MEGHALAYA,AP,17,B0101,Rural,Acceptable Performance,0.667999459,33383,55497,88880,4203,3655,7858,11557,7226,18783,2264,1239,3503,0.164504637,18960,2928,21888,3043,601,3644,1,1,66164,660,66890,133054
Not considered,Above average state,MIZORAM,35-39,0,MIZORAM,AP,15,B0101,Rural,Acceptable Performance,0.792974802,9492,15589,25081,406,192,598,1740,383,2123,317,97,414,0.126814,3619,392,4011,331,60,391,1,1,15168,657,16461,31629
Not considered,Above average state,RAJASTHAN,35-39,0,RAJASTHAN,AP,8,B0101,Rural,Acceptable Performance,0.636139529,633186,1358182,1991368,209874,136298,346172,493748,176162,669910,86529,19467,105996,0.11599846,331098,32023,363121,43436,9789,53225,1,2,1544561,569,1585834,3130395
Not considered,Above average state,TAMIL NADU,35-39,0,TAMIL NADU,AP,33,B0101,Rural,Acceptable Performance,0.684587176,816715,1164915,1981630,72049,73325,145374,210374,155838,366212,37604,20983,58587,0.168658916,454567,33639,488206,57266,10731,67997,1,1,1519260,610,1375375,2894635
Not considered,Above average state,TRIPURA,35-39,0,TRIPURA,AP,16,B0101,Rural,Acceptable Performance,0.548791867,19796,87838,107634,17789,9007,26796,19696,9191,28887,7172,1628,8800,0.25905399,47807,3001,50808,22820,1840,24660,1,2,94471,582,101658,196129
Not considered,Above average state,ANDAMAN & NICOBAR ISLANDS,40-49,0,ANDAMAN & NICOBAR ISLANDS,AP,35,B0101,Rural,Acceptable Performance,0.555263071,2916,13959,16875,361,920,1281,1178,1869,3047,369,408,777,0.318910204,9016,676,9692,1006,158,1164,1,2,13479,593,16912,30391
Not considered,Above average state,ANDHRA PRADESH,40-49,0,ANDHRA PRADESH,AP,28,B0101,Rural,Acceptable Performance,0.736151942,1868785,2995855,4864640,222645,176225,398870,469719,268375,738094,61116,28788,89904,0.138549508,839166,76397,915563,62132,14154,76286,1,1,3238786,635,3369415,6608201
Not considered,Above average state,CHHATTISGARH,40-49,0,CHHATTISGARH,AP,22,B0101,Rural,Acceptable Performance,0.636772408,491004,895552,1386556,170733,135715,306448,341136,175908,517044,54539,16587,71126,0.093111976,184138,18611,202749,21741,3908,25649,1,1,1070817,660,1106658,2177475
Not considered,Above average state,DAMAN & DIU,40-49,0,DAMAN & DIU,AP,25,B0101,Rural,Acceptable Performance,0.624460432,707,3199,3906,36,21,57,191,63,254,30,16,46,0.327577938,1926,123,2049,104,24,128,1,2,2854,588,3401,6255
Not considered,Above average state,GUJARAT,40-49,0,GUJARAT,AP,24,B0101,Rural,Acceptable Performance,0.625425595,597455,1891565,2489020,63011,35769,98780,452023,85932,537955,31220,8144,39364,0.229509247,863839,49544,913383,29698,5292,34990,1,1,1944537,603,2035185,3979722
Not considered,Above average state,MEGHALAYA,40-49,0,MEGHALAYA,AP,17,B0101,Rural,Acceptable Performance,0.69279628,53898,88552,142450,5631,4749,10380,17542,10331,27873,3336,1720,5056,0.147055677,26312,3925,30237,3405,642,4047,1,1,101088,660,104528,205616
Not considered,Above average state,MIZORAM,40-49,0,MIZORAM,AP,15,B0101,Rural,Acceptable Performance,0.809100976,15058,23668,38726,464,216,680,2487,540,3027,416,129,545,0.116269352,4994,571,5565,290,70,360,1,1,22955,657,24908,47863
Not considered,Above average state,RAJASTHAN,40-49,0,RAJASTHAN,AP,8,B0101,Rural,Acceptable Performance,0.643296854,1005752,2191737,3197489,295030,188253,483283,755766,260542,1016308,133227,30074,163301,0.119379809,535065,58309,593374,55906,12123,68029,1,2,2429810,569,2540662,4970472
Not considered,Above average state,TAMIL NADU,40-49,0,TAMIL NADU,AP,33,B0101,Rural,Acceptable Performance,0.693454932,1323383,2060123,3383506,90310,102473,192783,331369,273680,605049,59107,37587,96694,0.162721724,733395,60557,793952,50685,10382,61067,1,1,2447254,610,2431947,4879201
Not considered,Above average state,TRIPURA,40-49,0,TRIPURA,AP,16,B0101,Rural,Acceptable Performance,0.567057412,32289,139729,172018,23601,11458,35059,28724,12272,40996,10083,2186,12269,0.257354492,74000,4069,78069,26497,1917,28414,1,2,145096,582,158256,303352
Not considered,Above average state,ANDAMAN & NICOBAR ISLANDS,5-Sep,0,ANDAMAN & NICOBAR ISLANDS,AP,35,B0101,Rural,Acceptable Performance,0.013599792,126,136,262,35,28,63,69,62,131,12,5,17,0.978717882,9209,9646,18855,158,148,306,1,2,9416,593,9849,19265
Not considered,Above average state,ANDHRA PRADESH,5-Sep,0,ANDHRA PRADESH,AP,28,B0101,Rural,Acceptable Performance,0.009577507,22528,25138,47666,4324,4420,8744,13485,12911,26396,3873,3812,7685,0.983574613,2377891,2517231,4895122,11550,12210,23760,1,1,2417777,635,2559092,4976869
Not considered,Above average state,CHHATTISGARH,5-Sep,0,CHHATTISGARH,AP,22,B0101,Rural,Acceptable Performance,0.003498854,3667,4053,7720,1377,1431,2808,5280,4965,10245,9461,8870,18331,0.98354995,1070233,1099908,2170141,4530,4901,9431,1,1,1088641,660,1117796,2206437
Not considered,Above average state,DAMAN & DIU,5-Sep,0,DAMAN & DIU,AP,25,B0101,Rural,Acceptable Performance,0.002601006,7,8,15,5,3,8,8,3,11,0,0,0,0.99549159,2770,2971,5741,9,6,15,1,2,2785,588,2982,5767
Not considered,Above average state,GUJARAT,5-Sep,0,GUJARAT,AP,24,B0101,Rural,Acceptable Performance,0.006697269,9941,14227,24168,1670,1912,3582,9481,8587,18068,4235,4236,8471,0.985948426,1682922,1875006,3557928,7726,8637,16363,1,1,1706579,603,1902056,3608635
Not considered,Above average state,MEGHALAYA,5-Sep,0,MEGHALAYA,AP,17,B0101,Rural,Acceptable Performance,0.013530947,2163,2326,4489,885,848,1733,2325,2269,4594,961,930,1891,0.966921672,157962,162822,320784,3669,3601,7270,1,1,163411,660,168347,331758
Not considered,Above average state,MIZORAM,5-Sep,0,MIZORAM,AP,15,B0101,Rural,Acceptable Performance,0.003898545,127,126,253,30,28,58,113,108,221,283,281,564,0.984005178,31300,32558,63858,456,467,923,1,1,31823,657,33073,64896
Not considered,Above average state,RAJASTHAN,5-Sep,0,RAJASTHAN,AP,8,B0101,Rural,Acceptable Performance,0.005089957,15488,16713,32201,4107,3734,7841,18161,15380,33541,22688,21169,43857,0.982675872,2933061,3283719,6216780,14329,16287,30616,1,2,2989398,569,3336981,6326379
Not considered,Above average state,TAMIL NADU,5-Sep,0,TAMIL NADU,AP,33,B0101,Rural,Acceptable Performance,0.007474055,10261,11926,22187,2947,3213,6160,10477,10595,21072,728,722,1450,0.984939041,1418116,1505711,2923827,7838,8446,16284,1,1,1439582,610,1528954,2968536
Not considered,Above average state,TRIPURA,5-Sep,0,TRIPURA,AP,16,B0101,Rural,Acceptable Performance,0.002890065,331,439,770,262,284,546,545,570,1115,146,146,292,0.991828998,129359,134894,264253,1634,1686,3320,1,2,130381,582,136049,266430
Not considered,Above average state,ANDAMAN & NICOBAR ISLANDS,50-59,0,ANDAMAN & NICOBAR ISLANDS,AP,35,B0101,Rural,Acceptable Performance,0.528623882,1488,8734,10222,136,374,510,721,1106,1827,215,281,496,0.35124373,6037,755,6792,328,89,417,1,2,8461,593,10876,19337
Not considered,Above average state,ANDHRA PRADESH,50-59,0,ANDHRA PRADESH,AP,28,B0101,Rural,Acceptable Performance,0.6650376,1144456,1792775,2937231,128871,95492,224363,304267,165742,470009,48912,20685,69597,0.212786691,811392,128410,939802,42501,11986,54487,1,1,2309027,635,2107612,4416639
Not considered,Above average state,CHHATTISGARH,50-59,0,CHHATTISGARH,AP,22,B0101,Rural,Acceptable Performance,0.588569873,265218,526186,791404,81629,69346,150975,193119,102494,295613,40656,12229,52885,0.152250967,178038,26682,204720,11767,2495,14262,1,1,677031,660,667591,1344622
Not considered,Above average state,DAMAN & DIU,50-59,0,DAMAN & DIU,AP,25,B0101,Rural,Acceptable Performance,0.508935936,320,1531,1851,13,12,25,129,63,192,29,9,38,0.427825131,1372,184,1556,26,8,34,1,2,1850,588,1787,3637
Not considered,Above average state,GUJARAT,50-59,0,GUJARAT,AP,24,B0101,Rural,Acceptable Performance,0.57064682,326707,1194945,1521652,29831,16137,45968,263822,52858,316680,23571,6499,30070,0.299315705,710311,87826,798137,14113,3277,17390,1,1,1324411,603,1342128,2666539
Not considered,Above average state,MEGHALAYA,50-59,0,MEGHALAYA,AP,17,B0101,Rural,Acceptable Performance,0.684370044,28446,49230,77676,2581,2192,4773,8697,5603,14300,1861,1007,2868,0.164370044,15617,3039,18656,1276,327,1603,1,1,54621,660,58879,113500
Not considered,Above average state,MIZORAM,50-59,0,MIZORAM,AP,15,B0101,Rural,Acceptable Performance,0.797710909,10648,17161,27809,219,125,344,1778,442,2220,319,91,410,0.126846619,3808,614,4422,139,45,184,1,1,16553,657,18308,34861
Not considered,Above average state,RAJASTHAN,50-59,0,RAJASTHAN,AP,8,B0101,Rural,Acceptable Performance,0.604471081,576374,1358845,1935219,142325,98640,240965,438594,168462,607056,91814,24945,116759,0.169443275,457963,84511,542474,28252,7889,36141,1,2,1564745,569,1636763,3201508
Not considered,Above average state,TAMIL NADU,50-59,0,TAMIL NADU,AP,33,B0101,Rural,Acceptable Performance,0.648545996,853743,1378003,2231746,46126,52501,98627,213010,187429,400439,41695,27398,69093,0.215007877,641120,98755,739875,23930,7055,30985,1,1,1749568,610,1691585,3441153
Not considered,Above average state,TRIPURA,50-59,0,TRIPURA,AP,16,B0101,Rural,Acceptable Performance,0.541444218,17142,83160,100302,10119,6112,16231,14403,7546,21949,5256,1635,6891,0.30287343,50400,5707,56107,10247,1406,11653,1,2,87201,582,98048,185249
Not considered,Above average state,ANDAMAN & NICOBAR ISLANDS,60-69,0,ANDAMAN & NICOBAR ISLANDS,AP,35,B0101,Rural,Acceptable Performance,0.279751102,397,2840,3237,47,137,184,257,561,818,98,174,272,0.626047878,4443,2801,7244,100,79,179,1,2,5195,593,6376,11571
Not considered,Above average state,ANDHRA PRADESH,60-69,0,ANDHRA PRADESH,AP,28,B0101,Rural,Acceptable Performance,0.461915219,644829,1187706,1832535,67954,66287,134241,187949,149105,337054,45179,27746,72925,0.434744032,1248255,476485,1724740,39237,18441,57678,1,1,2126212,635,1841042,3967254
Not considered,Above average state,CHHATTISGARH,60-69,0,CHHATTISGARH,AP,22,B0101,Rural,Acceptable Performance,0.399256969,125263,281070,406333,36475,35850,72325,105467,71398,176865,36268,16361,52629,0.375245524,282029,99867,381896,8323,3568,11891,1,1,549027,660,468696,1017723
Not considered,Above average state,DAMAN & DIU,60-69,0,DAMAN & DIU,AP,25,B0101,Rural,Acceptable Performance,0.285208149,138,506,644,3,8,11,63,43,106,17,15,32,0.653675819,1074,402,1476,11,3,14,1,2,1292,588,966,2258
Not considered,Above average state,GUJARAT,60-69,0,GUJARAT,AP,24,B0101,Rural,Acceptable Performance,0.411673155,142223,570100,712323,11819,7400,19219,120329,36185,156514,16369,7587,23956,0.484027736,633432,204087,837519,8006,2903,10909,1,1,912353,603,817959,1730312
Not considered,Above average state,MEGHALAYA,60-69,0,MEGHALAYA,AP,17,B0101,Rural,Acceptable Performance,0.571609522,14159,25102,39261,1144,1011,2155,4273,3251,7524,1123,720,1843,0.292014268,14586,5471,20057,876,410,1286,1,1,34141,660,34544,68685
Not considered,Above average state,MIZORAM,60-69,0,MIZORAM,AP,15,B0101,Rural,Acceptable Performance,0.652187213,4503,8289,12792,107,61,168,957,410,1367,340,132,472,0.254053227,3599,1384,4983,91,46,137,1,1,9399,657,10215,19614
Not considered,Above average state,RAJASTHAN,60-69,0,RAJASTHAN,AP,8,B0101,Rural,Acceptable Performance,0.420037768,275974,696266,972240,59929,51357,111286,228525,128403,356928,73751,35066,108817,0.378745978,621251,255413,876664,15507,7350,22857,1,2,1199501,569,1115148,2314649
Not considered,Above average state,TAMIL NADU,60-69,0,TAMIL NADU,AP,33,B0101,Rural,Acceptable Performance,0.506627183,459460,810666,1270126,21884,27020,48904,120857,127490,248347,29236,22816,52052,0.373549824,680409,256089,936498,14364,7085,21449,1,1,1289962,610,1217061,2507023
Not considered,Above average state,TRIPURA,60-69,0,TRIPURA,AP,16,B0101,Rural,Acceptable Performance,0.3914085,7430,38647,46077,4170,3188,7358,6866,4978,11844,2795,1599,4394,0.470655193,41623,13783,55406,4004,1359,5363,1,2,58714,582,59007,117721
Not considered,Above average state,ANDAMAN & NICOBAR ISLANDS,60+,0,ANDAMAN & NICOBAR ISLANDS,AP,35,B0101,Rural,Acceptable Performance,0.234907185,514,3700,4214,55,179,234,326,768,1094,125,247,372,0.683371425,6967,5292,12259,129,109,238,1,2,7932,593,10007,17939
Not considered,Above average state,ANDHRA PRADESH,60+,0,ANDHRA PRADESH,AP,28,B0101,Rural,Acceptable Performance,0.383963336,783057,1562226,2345283,80557,83891,164448,227986,201798,429784,57378,41641,99019,0.529462479,2166792,1067213,3234005,51345,27422,78767,1,1,3235213,635,2872878,6108091
Not considered,Above average state,CHHATTISGARH,60+,0,CHHATTISGARH,AP,22,B0101,Rural,Acceptable Performance,0.333427169,157547,375452,532999,44743,46560,91303,133446,99565,233011,50233,27340,77573,0.472281391,521872,233092,754964,11382,5476,16858,1,1,863098,660,735449,1598547
Not considered,Above average state,DAMAN & DIU,60+,0,DAMAN & DIU,AP,25,B0101,Rural,Acceptable Performance,0.225788445,173,636,809,4,10,14,75,58,133,20,20,40,0.725927993,1850,751,2601,14,6,20,1,2,2118,588,1465,3583
Not considered,Above average state,GUJARAT,60+,0,GUJARAT,AP,24,B0101,Rural,Acceptable Performance,0.337108912,190019,782313,972332,15199,10190,25389,156495,53627,210122,23690,13244,36934,0.577236415,1186864,478074,1664938,11325,4481,15806,1,1,1557068,603,1327258,2884326
Not considered,Above average state,MEGHALAYA,60+,0,MEGHALAYA,AP,17,B0101,Rural,Acceptable Performance,0.505998904,19709,35708,55417,1551,1465,3016,5912,4900,10812,1599,1162,2761,0.370069394,28408,12122,40530,1207,571,1778,1,1,55628,660,53892,109520
Not considered,Above average state,MIZORAM,60+,0,MIZORAM,AP,15,B0101,Rural,Acceptable Performance,0.524556869,5751,11295,17046,142,87,229,1308,744,2052,575,335,910,0.384293452,8101,4387,12488,129,65,194,1,1,15735,657,16761,32496
Not considered,Above average state,RAJASTHAN,60+,0,RAJASTHAN,AP,8,B0101,Rural,Acceptable Performance,0.329533523,353706,939315,1293021,73506,67343,140849,290070,184539,474609,104214,62380,166594,0.507052362,1323134,666434,1989568,21407,11183,32590,1,2,2071124,569,1852668,3923792
Not considered,Above average state,TAMIL NADU,60+,0,TAMIL NADU,AP,33,B0101,Rural,Acceptable Performance,0.433591696,598680,1148303,1746983,27442,35966,63408,158017,183704,341721,39552,35404,74956,0.462991335,1259062,606375,1865437,19126,10067,29193,1,1,2055311,610,1973786,4029097
Not considered,Above average state,TRIPURA,60+,0,TRIPURA,AP,16,B0101,Rural,Acceptable Performance,0.323109597,10375,56109,66484,5472,4681,10153,9389,7946,17335,3922,2762,6684,0.560159018,80734,34526,115260,5465,2102,7567,1,2,104420,582,101343,205763
Not considered,Above average state,ANDAMAN & NICOBAR ISLANDS,70-79,0,ANDAMAN & NICOBAR ISLANDS,AP,35,B0101,Rural,Acceptable Performance,0.16470849,86,657,743,5,29,34,56,162,218,24,61,85,0.768122368,1706,1759,3465,16,19,35,1,2,1872,593,2639,4511
Not considered,Above average state,ANDHRA PRADESH,70-79,0,ANDHRA PRADESH,AP,28,B0101,Rural,Acceptable Performance,0.26461156,109018,316493,425511,9953,14970,24923,32156,44726,76882,10298,11788,22086,0.673843435,659044,424536,1083580,10484,7779,18263,1,1,810516,635,797543,1608059
Not considered,Above average state,CHHATTISGARH,70-79,0,CHHATTISGARH,AP,22,B0101,Rural,Acceptable Performance,0.237903254,25851,76824,102675,6375,8420,14795,22435,22617,45052,11428,8481,19909,0.611578769,173877,90070,263947,2433,1419,3852,1,1,233591,660,197992,431583
Not considered,Above average state,DAMAN & DIU,70-79,0,DAMAN & DIU,AP,25,B0101,Rural,Acceptable Performance,0.126390293,27,98,125,0,2,2,10,14,24,2,5,7,0.842264914,563,270,833,2,3,5,1,2,602,588,387,989
Not considered,Above average state,GUJARAT,70-79,0,GUJARAT,AP,24,B0101,Rural,Acceptable Performance,0.254711712,37650,171654,209304,2575,2109,4684,28607,13749,42356,5788,4303,10091,0.68146311,379539,180439,559978,2528,1141,3669,1,1,451584,603,370145,821729
Not considered,Above average state,MEGHALAYA,70-79,0,MEGHALAYA,AP,17,B0101,Rural,Acceptable Performance,0.431946674,4310,8067,12377,313,333,646,1260,1227,2487,368,326,694,0.457039157,8991,4105,13096,243,103,346,1,1,14929,660,13725,28654
Not considered,Above average state,MIZORAM,70-79,0,MIZORAM,AP,15,B0101,Rural,Acceptable Performance,0.391887471,1048,2546,3594,28,24,52,305,282,587,182,163,345,0.506487842,2853,1792,4645,26,12,38,1,1,4388,657,4783,9171
Not considered,Above average state,RAJASTHAN,70-79,0,RAJASTHAN,AP,8,B0101,Rural,Acceptable Performance,0.229872801,63075,203594,266669,10894,13187,24081,51031,47025,98056,25213,21825,47038,0.645053928,476283,272026,748309,4656,2932,7588,1,2,615602,569,544470,1160072
Not considered,Above average state,TAMIL NADU,70-79,0,TAMIL NADU,AP,33,B0101,Rural,Acceptable Performance,0.350357705,116803,281347,398150,4590,7505,12095,30819,46367,77186,8597,10109,18706,0.565260777,408916,233452,642368,4041,2451,6492,1,1,565135,610,571275,1136410
Not considered,Above average state,TRIPURA,70-79,0,TRIPURA,AP,16,B0101,Rural,Acceptable Performance,0.265064739,2259,13361,15620,1008,1166,2174,1939,2240,4179,871,863,1734,0.634594173,24904,12492,37396,1044,537,1581,1,2,29973,582,28956,58929
Not considered,Above average state,ANDAMAN & NICOBAR ISLANDS,80+,0,ANDAMAN & NICOBAR ISLANDS,AP,35,B0101,Rural,Acceptable Performance,0.126009693,31,203,234,3,13,16,13,45,58,3,12,15,0.834679591,818,732,1550,13,11,24,1,2,865,593,992,1857
Not considered,Above average state,ANDHRA PRADESH,80+,0,ANDHRA PRADESH,AP,28,B0101,Rural,Acceptable Performance,0.163739869,29210,58027,87237,2650,2634,5284,7881,7967,15848,1901,2107,4008,0.798991325,259493,166192,425685,1624,1202,2826,1,1,298485,635,234293,532778
Not considered,Above average state,CHHATTISGARH,80+,0,CHHATTISGARH,AP,22,B0101,Rural,Acceptable Performance,0.160753412,6433,17558,23991,1893,2290,4183,5544,5550,11094,2537,2498,5035,0.731173069,65966,43155,109121,626,489,1115,1,1,80480,660,68761,149241
Not considered,Above average state,DAMAN & DIU,80+,0,DAMAN & DIU,AP,25,B0101,Rural,Acceptable Performance,0.119047619,8,32,40,1,0,1,2,1,3,1,0,1,0.869047619,213,79,292,1,0,1,1,2,224,588,112,336
Not considered,Above average state,GUJARAT,80+,0,GUJARAT,AP,24,B0101,Rural,Acceptable Performance,0.152594911,10146,40559,50705,805,681,1486,7559,3693,11252,1533,1354,2887,0.804854267,173893,93548,267441,791,437,1228,1,1,193131,603,139154,332285
Not considered,Above average state,MEGHALAYA,80+,0,MEGHALAYA,AP,17,B0101,Rural,Acceptable Performance,0.310237255,1240,2539,3779,94,121,215,379,422,801,108,116,224,0.605615303,4831,2546,7377,88,58,146,1,1,6558,660,5623,12181
Not considered,Above average state,MIZORAM,80+,0,MIZORAM,AP,15,B0101,Rural,Acceptable Performance,0.177849636,200,460,660,7,2,9,46,52,98,53,40,93,0.770681757,1649,1211,2860,12,7,19,1,1,1948,657,1763,3711
Not considered,Above average state,RAJASTHAN,80+,0,RAJASTHAN,AP,8,B0101,Rural,Acceptable Performance,0.12049765,14657,39455,54112,2683,2799,5482,10514,9111,19625,5250,5489,10739,0.811887207,225600,138995,364595,1244,901,2145,1,2,256021,569,193050,449071
Not considered,Above average state,TAMIL NADU,80+,0,TAMIL NADU,AP,33,B0101,Rural,Acceptable Performance,0.204081791,22417,56290,78707,968,1441,2409,6341,9847,16188,1719,2479,4198,0.743058725,169737,116834,286571,721,531,1252,1,1,200214,610,185450,385664
Not considered,Above average state,TRIPURA,80+,0,TRIPURA,AP,16,B0101,Rural,Acceptable Performance,0.164428262,686,4101,4787,294,327,621,584,728,1312,256,300,556,0.771407962,14207,8251,22458,417,206,623,1,2,15733,582,13380,29113
Not considered,Above average state,ANDAMAN & NICOBAR ISLANDS,Age not stated,0,ANDAMAN & NICOBAR ISLANDS,AP,35,B0101,Rural,Acceptable Performance,0.233333333,6,36,42,2,4,6,1,11,12,1,2,3,0.683333333,71,52,123,10,8,18,1,2,79,593,101,180
Not considered,Above average state,ANDHRA PRADESH,Age not stated,0,ANDHRA PRADESH,AP,28,B0101,Rural,Acceptable Performance,0.383453983,66756,87177,153933,7730,6644,14374,18550,12728,31278,2233,1439,3672,0.529484005,112285,100270,212555,3358,3156,6514,1,1,199824,635,201614,401438
Not considered,Above average state,CHHATTISGARH,Age not stated,0,CHHATTISGARH,AP,22,B0101,Rural,Acceptable Performance,0.238936155,1269,2073,3342,461,479,940,845,663,1508,256,154,410,0.623936512,4375,4352,8727,128,104,232,1,1,6745,660,7242,13987
Not considered,Above average state,DAMAN & DIU,Age not stated,0,DAMAN & DIU,AP,25,B0101,Rural,Acceptable Performance,0.361445783,8,22,30,0,0,0,3,0,3,0,0,0,0.602409639,29,21,50,0,2,2,1,2,40,588,43,83
Not considered,Above average state,GUJARAT,Age not stated,0,GUJARAT,AP,24,B0101,Rural,Acceptable Performance,0.332610086,9523,28954,38477,1418,1358,2776,8139,3833,11972,745,493,1238,0.553197559,38002,25993,63995,823,659,1482,1,1,56409,603,59273,115682
Not considered,Above average state,MEGHALAYA,Age not stated,0,MEGHALAYA,AP,17,B0101,Rural,Acceptable Performance,0.319807572,560,969,1529,93,141,234,209,245,454,34,44,78,0.568918636,1377,1343,2720,45,42,87,1,1,2180,660,2601,4781
Not considered,Above average state,MIZORAM,Age not stated,0,MIZORAM,AP,15,B0101,Rural,Acceptable Performance,0.421428571,44,74,118,2,1,3,10,5,15,2,0,2,0.517857143,70,75,145,1,3,4,1,1,126,657,154,280
Not considered,Above average state,RAJASTHAN,Age not stated,0,RAJASTHAN,AP,8,B0101,Rural,Acceptable Performance,0.299123024,21470,42688,64158,7268,5867,13135,19052,8984,28036,4356,2194,6550,0.53962711,60953,54790,115743,2379,2327,4706,1,2,105831,569,108656,214487
Not considered,Above average state,TAMIL NADU,Age not stated,0,TAMIL NADU,AP,33,B0101,Rural,Acceptable Performance,0.249574984,3538,5417,8955,311,363,674,1168,1109,2277,161,130,291,0.678855104,12394,11964,24358,288,265,553,1,1,17261,610,18620,35881
Not considered,Above average state,TRIPURA,Age not stated,0,TRIPURA,AP,16,B0101,Rural,Acceptable Performance,0.219323671,46,181,227,24,26,50,41,37,78,12,6,18,0.687922705,368,344,712,49,9,58,1,2,467,582,568,1035
Not considered,Above average state,ANDAMAN & NICOBAR ISLANDS,Oct-14,0,ANDAMAN & NICOBAR ISLANDS,AP,35,B0101,Rural,Acceptable Performance,0.0176199,154,220,374,51,70,121,92,134,226,38,51,89,0.96753981,10211,10326,20537,364,412,776,1,2,10495,593,10731,21226
Not considered,Above average state,ANDHRA PRADESH,Oct-14,0,ANDHRA PRADESH,AP,28,B0101,Rural,Acceptable Performance,0.047126515,132798,129480,262278,24149,20326,44475,49754,40113,89867,20425,18046,38471,0.929813516,2502565,2672221,5174786,27883,28576,56459,1,1,2705542,635,2859860,5565402
Not considered,Above average state,CHHATTISGARH,Oct-14,0,CHHATTISGARH,AP,22,B0101,Rural,Acceptable Performance,0.019453824,19710,24832,44542,18018,17031,35049,35628,29545,65173,48208,43523,91731,0.912017984,1031007,1057174,2088181,13690,14759,28449,1,1,1134553,660,1155074,2289627
Not considered,Above average state,DAMAN & DIU,Oct-14,0,DAMAN & DIU,AP,25,B0101,Rural,Acceptable Performance,0.018468824,28,89,117,2,7,9,7,13,20,1,2,3,0.977900552,2997,3198,6195,27,29,56,1,2,3033,588,3302,6335
Not considered,Above average state,GUJARAT,Oct-14,0,GUJARAT,AP,24,B0101,Rural,Acceptable Performance,0.034910548,50028,82209,132237,14465,15428,29893,62554,39574,102128,22541,18444,40985,0.927307642,1663379,1849152,3512531,19902,22650,42552,1,1,1798502,603,1989379,3787881
Not considered,Above average state,MEGHALAYA,Oct-14,0,MEGHALAYA,AP,17,B0101,Rural,Acceptable Performance,0.041336885,5032,8004,13036,1994,2371,4365,4985,5617,10602,3436,3584,7020,0.90278412,142123,142579,284702,5189,4931,10120,1,1,155576,660,159784,315360
Not considered,Above average state,MIZORAM,Oct-14,0,MIZORAM,AP,15,B0101,Rural,Acceptable Performance,0.029340301,853,910,1763,155,146,301,545,392,937,960,885,1845,0.924360937,26894,28649,55543,844,870,1714,1,1,29252,657,30836,60088
Not considered,Above average state,RAJASTHAN,Oct-14,0,RAJASTHAN,AP,8,B0101,Rural,Acceptable Performance,0.027259576,90151,88050,178201,51816,43573,95389,148014,92832,240846,131856,117907,249763,0.8976915,2720436,3147943,5868379,51184,56823,108007,1,2,3090457,569,3446732,6537189
Not considered,Above average state,TAMIL NADU,Oct-14,0,TAMIL NADU,AP,33,B0101,Rural,Acceptable Performance,0.02094215,29276,40360,69636,5848,6845,12693,18414,19640,38054,2626,2723,5349,0.966004944,1548678,1663443,3212121,15290,18109,33399,1,1,1598994,610,1726166,3325160
Not considered,Above average state,TRIPURA,Oct-14,0,TRIPURA,AP,16,B0101,Rural,Acceptable Performance,0.011420737,1041,2191,3232,1603,1715,3318,2090,2073,4163,1083,1001,2084,0.96650459,133876,139639,273515,6210,6351,12561,1,2,138090,582,144904,282994
Not considered,Above average state,ANDAMAN & NICOBAR ISLANDS,Total,0,ANDAMAN & NICOBAR ISLANDS,AP,35,B0101,Rural,Acceptable Performance,0.305222001,11955,60411,72366,2805,7293,10098,5916,11280,17196,1928,2979,4907,0.601552977,91007,51617,142624,14261,7226,21487,1,2,110806,593,126287,237093
Not considered,Above average state,ANDHRA PRADESH,Total,0,ANDHRA PRADESH,AP,28,B0101,Rural,Acceptable Performance,0.428357682,9557051,14585917,24142968,1292416,1081311,2373727,2582327,1663176,4245503,414740,249096,663836,0.484538153,15564343,11745052,27309395,871063,719975,1591038,1,1,28118461,635,28243241,56361702
Not considered,Above average state,CHHATTISGARH,Total,0,CHHATTISGARH,AP,22,B0101,Rural,Acceptable Performance,0.32462687,2251240,4114031,6365271,984828,910029,1894857,1832095,1151107,2983202,457521,257120,714641,0.486784271,5269679,4275168,9544847,269731,198433,468164,1,1,9810535,660,9797426,19607961
Not considered,Above average state,DAMAN & DIU,Total,0,DAMAN & DIU,AP,25,B0101,Rural,Acceptable Performance,0.35490761,3304,18131,21435,203,202,405,938,561,1499,199,170,369,0.61416319,23560,13533,37093,1410,943,2353,1,2,28001,588,32395,60396
Not considered,Above average state,GUJARAT,Total,0,GUJARAT,AP,24,B0101,Rural,Acceptable Performance,0.342362123,2736781,9141339,11878120,438762,439937,878699,2410088,894380,3304468,251639,135865,387504,0.551224457,11496942,7627575,19124517,346304,265825,612129,1,1,16895450,603,17799159,34694609
Not considered,Above average state,MEGHALAYA,Total,0,MEGHALAYA,AP,17,B0101,Rural,Acceptable Performance,0.308234367,275529,455430,730959,41924,43645,85569,107560,83435,190995,28557,22947,51504,0.589507468,765533,632448,1397981,59851,39219,99070,1,1,1177179,660,1194260,2371439
Not considered,Above average state,MIZORAM,Total,0,MIZORAM,AP,15,B0101,Rural,Acceptable Performance,0.414559365,82936,134888,217824,4944,3364,8308,18398,6745,25143,5957,3458,9415,0.519670368,149009,124044,273053,7554,5933,13487,1,1,256300,657,269135,525435
Not considered,Above average state,RAJASTHAN,Total,0,RAJASTHAN,AP,8,B0101,Rural,Acceptable Performance,0.314043349,5103506,11069837,16173343,1831142,1558293,3389435,4387144,2104692,6491836,1119114,600940,1720054,0.526503566,14248841,12866278,27115119,723486,696685,1420171,1,2,24858605,569,26641747,51500352
Not considered,Above average state,TAMIL NADU,Total,0,TAMIL NADU,AP,33,B0101,Rural,Acceptable Performance,0.4120141,5786642,9552474,15339116,525065,628601,1153666,1565909,1444865,3010774,294244,217196,511440,0.493377982,10903730,7464530,18368260,864551,623380,1487931,1,1,18550525,610,18679065,37229590
Not considered,Above average state,TRIPURA,Total,0,TRIPURA,AP,16,B0101,Rural,Acceptable Performance,0.28630168,139560,637023,776583,132370,101360,233730,153802,104727,258529,54947,26017,80964,0.588537949,976982,619406,1596388,229392,88977,318369,1,2,1325291,582,1387173,2712464
Optimum Performing/Ideal role models,Above average state,HIMACHAL PRADESH,15-19,0,HIMACHAL PRADESH,AP,2,B0101,Rural,Acceptable Performance,0.092730616,19339,34073,53412,22595,27149,49744,33448,31170,64618,36687,38005,74692,0.665407966,185963,197306,383269,24118,29015,53133,1,1,275437,696,300554,575991
Optimum Performing/Ideal role models,Above average state,SIKKIM,15-19,0,SIKKIM,AP,11,B0101,Rural,Acceptable Performance,0.173506176,3167,5640,8807,1006,1274,2280,2765,2773,5538,2400,2245,4645,0.625879154,16484,15285,31769,2260,2048,4308,1,1,24816,741,25943,50759
Optimum Performing/Ideal role models,Above average state,HIMACHAL PRADESH,15-59,0,HIMACHAL PRADESH,AP,2,B0101,Rural,Acceptable Performance,0.4210193,513947,1127446,1641393,266231,291496,557727,519255,332872,852127,208825,120665,329490,0.275894503,714259,361348,1075607,143179,92438,235617,1,1,1956286,696,1942331,3898617
Optimum Performing/Ideal role models,Above average state,SIKKIM,15-59,0,SIKKIM,AP,11,B0101,Rural,Acceptable Performance,0.535655143,50072,107454,157526,7965,7287,15252,24956,16232,41188,9556,6442,15998,0.269888228,51170,28199,79369,9362,5960,15322,1,1,135754,741,158327,294081
Optimum Performing/Ideal role models,Above average state,HIMACHAL PRADESH,20-24,0,HIMACHAL PRADESH,AP,2,B0101,Rural,Acceptable Performance,0.309044205,59004,118214,177218,53188,59988,113176,71424,55459,126883,33105,24895,58000,0.368544867,124739,86599,211338,40240,35648,75888,1,1,288272,696,285167,573439
Optimum Performing/Ideal role models,Above average state,SIKKIM,20-24,0,SIKKIM,AP,11,B0101,Rural,Acceptable Performance,0.438712655,7178,14687,21865,2039,1951,3990,4171,3380,7551,1801,1534,3335,0.342864022,10388,6700,17088,3150,2212,5362,1,1,23538,741,26301,49839
Optimum Performing/Ideal role models,Above average state,HIMACHAL PRADESH,25-29,0,HIMACHAL PRADESH,AP,2,B0101,Rural,Acceptable Performance,0.458706468,76502,163679,240181,50156,52454,102610,78829,53037,131866,27308,14237,41545,0.210106855,85950,24063,110013,28649,13331,41980,1,1,268589,696,255016,523605
Optimum Performing/Ideal role models,Above average state,SIKKIM,25-29,0,SIKKIM,AP,11,B0101,Rural,Acceptable Performance,0.60257785,8726,19371,28097,1755,1503,3258,4355,2793,7148,1397,828,2225,0.196405593,6675,2483,9158,1965,1000,2965,1,1,21153,741,25475,46628
Optimum Performing/Ideal role models,Above average state,HIMACHAL PRADESH,30-34,0,HIMACHAL PRADESH,AP,2,B0101,Rural,Acceptable Performance,0.513213495,77750,171351,249101,41003,43581,84584,73518,47278,120796,24314,10431,34745,0.166331187,70521,10212,80733,18212,5026,23238,1,1,246103,696,239272,485375
Optimum Performing/Ideal role models,Above average state,SIKKIM,30-34,0,SIKKIM,AP,11,B0101,Rural,Acceptable Performance,0.666657757,7715,17226,24941,1053,945,1998,3419,1990,5409,1030,532,1562,0.147011654,4460,1040,5500,879,341,1220,1,1,16624,741,20788,37412
Optimum Performing/Ideal role models,Above average state,HIMACHAL PRADESH,35-39,0,HIMACHAL PRADESH,AP,2,B0101,Rural,Acceptable Performance,0.537825921,77220,169790,247010,34198,36699,70897,69735,42101,111836,22547,8943,31490,0.150103968,61867,7072,68939,12819,2888,15707,1,1,231369,696,227906,459275
Optimum Performing/Ideal role models,Above average state,SIKKIM,35-39,0,SIKKIM,AP,11,B0101,Rural,Acceptable Performance,0.67686239,6856,14078,20934,804,551,1355,3068,1525,4593,798,362,1160,0.137124935,3593,648,4241,508,140,648,1,1,14315,741,16613,30928
Optimum Performing/Ideal role models,Above average state,HIMACHAL PRADESH,40-49,0,HIMACHAL PRADESH,AP,2,B0101,Rural,Acceptable Performance,0.545320272,125819,280678,406497,43318,47039,90357,113586,61051,174637,36352,13120,49472,0.154034997,101045,13777,114822,13570,3857,17427,1,1,376802,696,368626,745428
Optimum Performing/Ideal role models,Above average state,SIKKIM,40-49,0,SIKKIM,AP,11,B0101,Rural,Acceptable Performance,0.687789897,10370,22104,32474,879,670,1549,4400,2238,6638,1205,518,1723,0.135126549,5444,936,6380,413,156,569,1,1,21419,741,25796,47215
Optimum Performing/Ideal role models,Above average state,HIMACHAL PRADESH,5-Sep,0,HIMACHAL PRADESH,AP,2,B0101,Rural,Acceptable Performance,0.007387096,1830,2141,3971,784,934,1718,3696,3694,7390,9455,9882,19337,0.94289371,240137,266724,506861,1741,2027,3768,1,1,255118,696,282441,537559
Optimum Performing/Ideal role models,Above average state,SIKKIM,5-Sep,0,SIKKIM,AP,11,B0101,Rural,Acceptable Performance,0.013202591,252,331,583,38,36,74,284,276,560,326,337,663,0.959101409,20962,21390,42352,219,216,435,1,1,21824,741,22334,44158
Optimum Performing/Ideal role models,Above average state,HIMACHAL PRADESH,50-59,0,HIMACHAL PRADESH,AP,2,B0101,Rural,Acceptable Performance,0.500414563,78313,189661,267974,21773,24586,46359,78715,42776,121491,28512,11034,39546,0.198864994,84174,22319,106493,5571,2673,8244,1,1,269714,696,265790,535504
Optimum Performing/Ideal role models,Above average state,SIKKIM,50-59,0,SIKKIM,AP,11,B0101,Rural,Acceptable Performance,0.65201278,6060,14348,20408,429,393,822,2778,1533,4311,925,423,1348,0.167188498,4126,1107,5233,187,63,250,1,1,13889,741,17411,31300
Optimum Performing/Ideal role models,Above average state,HIMACHAL PRADESH,60-69,0,HIMACHAL PRADESH,AP,2,B0101,Rural,Acceptable Performance,0.308827182,36600,74071,110671,8526,11772,20298,42706,35873,78579,20717,12808,33525,0.378346853,81055,54529,135584,2173,2049,4222,1,1,181078,696,177281,358359
Optimum Performing/Ideal role models,Above average state,SIKKIM,60-69,0,SIKKIM,AP,11,B0101,Rural,Acceptable Performance,0.491059927,2700,6830,9530,176,231,407,1402,1303,2705,634,435,1069,0.314474159,4116,1987,6103,128,70,198,1,1,8852,741,10555,19407
Optimum Performing/Ideal role models,Above average state,HIMACHAL PRADESH,60+,0,HIMACHAL PRADESH,AP,2,B0101,Rural,Acceptable Performance,0.254381696,53611,111557,165168,11380,16062,27442,61243,55109,116352,33697,23578,57275,0.478208572,187310,123187,310497,3209,2822,6031,1,1,335861,696,313431,649292
Optimum Performing/Ideal role models,Above average state,SIKKIM,60+,0,SIKKIM,AP,11,B0101,Rural,Acceptable Performance,0.409819277,3583,10023,13606,237,326,563,1890,2048,3938,878,762,1640,0.422168675,8373,5643,14016,175,109,284,1,1,14724,741,18476,33200
Optimum Performing/Ideal role models,Above average state,HIMACHAL PRADESH,70-79,0,HIMACHAL PRADESH,AP,2,B0101,Rural,Acceptable Performance,0.217748442,13063,28503,41566,2197,3350,5547,14419,14798,29217,9713,7684,17397,0.538058568,62884,39826,102710,715,567,1282,1,1,100079,696,90811,190890
Optimum Performing/Ideal role models,Above average state,SIKKIM,70-79,0,SIKKIM,AP,11,B0101,Rural,Acceptable Performance,0.326777157,684,2589,3273,49,79,128,404,634,1038,197,254,451,0.524560703,2957,2297,5254,32,23,55,1,1,4242,741,5774,10016
Optimum Performing/Ideal role models,Above average state,HIMACHAL PRADESH,80+,0,HIMACHAL PRADESH,AP,2,B0101,Rural,Acceptable Performance,0.129254421,3948,8983,12931,657,940,1597,4118,4438,8556,3267,3086,6353,0.721719661,43371,28832,72203,321,206,527,1,1,54704,696,45339,100043
Optimum Performing/Ideal role models,Above average state,SIKKIM,80+,0,SIKKIM,AP,11,B0101,Rural,Acceptable Performance,0.212602595,199,604,803,12,16,28,84,111,195,47,73,120,0.703997882,1300,1359,2659,15,16,31,1,1,1630,741,2147,3777
Optimum Performing/Ideal role models,Above average state,HIMACHAL PRADESH,Age not stated,0,HIMACHAL PRADESH,AP,2,B0101,Rural,Acceptable Performance,0.208182399,617,1337,1954,316,350,666,645,503,1148,348,226,574,0.608352866,2877,2833,5710,213,140,353,1,1,4487,696,4899,9386
Optimum Performing/Ideal role models,Above average state,SIKKIM,Age not stated,0,SIKKIM,AP,11,B0101,Rural,Acceptable Performance,0.324214792,111,209,320,18,8,26,41,38,79,37,27,64,0.530901722,267,257,524,20,10,30,1,1,456,741,531,987
Optimum Performing/Ideal role models,Above average state,HIMACHAL PRADESH,Oct-14,0,HIMACHAL PRADESH,AP,2,B0101,Rural,Acceptable Performance,0.016583802,4230,5393,9623,3672,3760,7432,12551,11984,24535,29076,29971,59047,0.839375113,228908,258152,487060,3279,3965,7244,1,1,274765,696,305500,580265
Optimum Performing/Ideal role models,Above average state,SIKKIM,Oct-14,0,SIKKIM,AP,11,B0101,Rural,Acceptable Performance,0.031557165,650,997,1647,200,276,476,1122,1125,2247,1841,1885,3726,0.853997816,21990,22581,44571,518,531,1049,1,1,25603,741,26588,52191
Optimum Performing/Ideal role models,Above average state,HIMACHAL PRADESH,Total,0,HIMACHAL PRADESH,AP,2,B0101,Rural,Acceptable Performance,0.295028214,574235,1247874,1822109,282383,312602,594985,597390,404162,1001552,281401,184322,465723,0.467396799,1612679,1273987,2886666,151621,101392,253013,1,1,3065705,696,3110345,6176050
Optimum Performing/Ideal role models,Above average state,SIKKIM,Total,0,SIKKIM,AP,11,B0101,Rural,Acceptable Performance,0.380048972,54668,119014,173682,8458,7933,16391,28293,19719,48012,12638,9453,22091,0.466552443,118603,94611,213214,10294,6826,17120,1,1,214202,741,242797,456999
Can be emulated,Above average state,KARNATAKA,15-19,0,KARNATAKA,AP,29,B0101,Total,Acceptable Performance,0.221918402,415341,877839,1293180,59029,87306,146335,181362,196613,377975,31769,41050,72819,0.70072231,2156757,1926546,4083303,204666,234359,439025,1,2,2785229,592,3042048,5827277
Can be emulated,Above average state,MAHARASHTRA,15-19,0,MAHARASHTRA,AP,27,B0101,Total,Acceptable Performance,0.184530886,669243,1291816,1961059,88713,146975,235688,188112,223145,411257,49395,60750,110145,0.766406452,4010117,4134689,8144806,297264,463695,760959,1,2,4916867,596,5710400,10627267
Can be emulated,Above average state,KARNATAKA,15-59,0,KARNATAKA,AP,29,B0101,Total,Acceptable Performance,0.539100066,6412950,14737854,21150804,461713,561525,1023238,2010578,1460633,3471211,243293,210119,453412,0.360867589,10606525,3551588,14158113,887706,651539,1539245,1,2,19273346,592,19960194,39233540
Can be emulated,Above average state,MAHARASHTRA,15-59,0,MAHARASHTRA,AP,27,B0101,Total,Acceptable Performance,0.550852115,12161280,26917539,39078819,825790,1130624,1956414,2215691,1912222,4127913,351503,306311,657814,0.381688635,19224045,7853896,27077941,1366089,1397483,2763572,1,2,33952519,596,36989968,70942487
Can be emulated,Above average state,KARNATAKA,20-24,0,KARNATAKA,AP,29,B0101,Total,Acceptable Performance,0.448638245,806419,1908990,2715409,89052,140208,229260,284488,283417,567905,37952,43949,81901,0.444001198,1814113,873230,2687343,273620,256134,529754,1,2,2942972,592,3109586,6052558
Can be emulated,Above average state,MAHARASHTRA,20-24,0,MAHARASHTRA,AP,27,B0101,Total,Acceptable Performance,0.445695893,1569710,3373488,4943198,154101,266493,420594,336529,371893,708422,58691,68783,127474,0.478936821,3280922,2030950,5311872,422781,559207,981988,1,2,5245852,596,5845114,11090966
Can be emulated,Above average state,KARNATAKA,25-29,0,KARNATAKA,AP,29,B0101,Total,Acceptable Performance,0.577469079,1004614,2328310,3332924,82455,108733,191188,311790,249021,560811,36462,32878,69340,0.313349699,1539486,269045,1808531,178793,96022,274815,1,2,2892352,592,2879254,5771606
Can be emulated,Above average state,MAHARASHTRA,25-29,0,MAHARASHTRA,AP,27,B0101,Total,Acceptable Performance,0.604624192,1832986,4302204,6135190,134931,205115,340046,329276,319968,649244,49638,45678,95316,0.321999272,2662653,604710,3267363,268457,216882,485339,1,2,4874553,596,5272560,10147113
Can be emulated,Above average state,KARNATAKA,30-34,0,KARNATAKA,AP,29,B0101,Total,Acceptable Performance,0.635391348,901632,2083678,2985310,58991,66463,125454,264362,179906,444268,29440,22697,52137,0.25895415,1113352,103313,1216665,79598,27718,107316,1,2,2308786,592,2389594,4698380
Can be emulated,Above average state,MAHARASHTRA,30-34,0,MAHARASHTRA,AP,27,B0101,Total,Acceptable Performance,0.661389035,1782537,4035244,5817781,115066,143044,258110,303514,245133,548647,42360,31583,73943,0.267832398,2131599,224337,2355936,140370,63858,204228,1,2,4260010,596,4536297,8796307
Can be emulated,Above average state,KARNATAKA,35-39,0,KARNATAKA,AP,29,B0101,Total,Acceptable Performance,0.652615478,1000451,2063873,3064324,59019,55572,114591,289059,163883,452942,31161,20614,51775,0.239893889,1055692,70718,1126410,62028,14383,76411,1,2,2376363,592,2319088,4695451
Can be emulated,Above average state,MAHARASHTRA,35-39,0,MAHARASHTRA,AP,27,B0101,Total,Acceptable Performance,0.681387532,1802446,3817066,5619512,107472,120007,227479,296746,214875,511621,40307,27140,67447,0.248398236,1898227,150353,2048580,98162,32316,130478,1,2,4037726,596,4209434,8247160
Can be emulated,Above average state,KARNATAKA,40-49,0,KARNATAKA,AP,29,B0101,Total,Acceptable Performance,0.65951364,1460098,3385015,4845113,74912,70819,145731,425640,244957,670597,45395,30860,76255,0.23882535,1632760,121769,1754529,59755,14430,74185,1,2,3563893,592,3782601,7346494
Can be emulated,Above average state,MAHARASHTRA,40-49,0,MAHARASHTRA,AP,27,B0101,Total,Acceptable Performance,0.684890997,2829695,6230415,9060110,149694,165825,315519,467288,329326,796614,63651,42166,105817,0.246890531,3006866,259136,3266002,96923,37022,133945,1,2,6367500,596,6861043,13228543
Can be emulated,Above average state,KARNATAKA,5-Sep,0,KARNATAKA,AP,29,B0101,Total,Acceptable Performance,0.009492114,22534,27219,49753,3586,3808,7394,18627,19249,37876,3086,3336,6422,0.982056503,2500592,2646866,5147458,13321,14595,27916,1,2,2544839,592,2696670,5241509
Can be emulated,Above average state,MAHARASHTRA,5-Sep,0,MAHARASHTRA,AP,27,B0101,Total,Acceptable Performance,0.014754109,65641,79254,144895,5262,6160,11422,28065,31016,59081,5107,5379,10486,0.978162147,4543664,5062528,9606192,23691,27059,50750,1,2,4642477,596,5178177,9820654
Can be emulated,Above average state,KARNATAKA,50-59,0,KARNATAKA,AP,29,B0101,Total,Acceptable Performance,0.601957877,824395,2090149,2914544,38255,32424,70679,253877,142836,396713,31114,18071,49185,0.305948192,1294365,186967,1481332,29246,8493,37739,1,2,2403751,592,2438023,4841774
Can be emulated,Above average state,MAHARASHTRA,50-59,0,MAHARASHTRA,AP,27,B0101,Total,Acceptable Performance,0.62940222,1674663,3867306,5541969,75813,83165,158978,294226,207882,502108,47461,30211,77672,0.304752081,2233661,449721,2683382,42132,24503,66635,1,2,4250011,596,4555120,8805131
Can be emulated,Above average state,KARNATAKA,60-69,0,KARNATAKA,AP,29,B0101,Total,Acceptable Performance,0.414246414,410023,1073050,1483073,19047,18172,37219,141999,96833,238832,22747,15110,37857,0.508469847,1287085,533324,1820409,19511,10460,29971,1,2,1861854,592,1718317,3580171
Can be emulated,Above average state,MAHARASHTRA,60-69,0,MAHARASHTRA,AP,27,B0101,Total,Acceptable Performance,0.434901363,1040727,1882172,2922899,45629,45161,90790,208084,148274,356358,47529,29686,77215,0.500586832,2267615,1096745,3364360,33649,22258,55907,1,2,3563955,596,3156877,6720832
Can be emulated,Above average state,KARNATAKA,60+,0,KARNATAKA,AP,29,B0101,Total,Acceptable Performance,0.34280712,526406,1458801,1985207,24060,24552,48612,182539,138661,321200,31261,23513,54774,0.592269392,2303754,1126097,3429851,26734,14630,41364,1,2,3043960,592,2747072,5791032
Can be emulated,Above average state,MAHARASHTRA,60+,0,MAHARASHTRA,AP,27,B0101,Total,Acceptable Performance,0.362951975,1351662,2679622,4031284,58290,62625,120915,276177,226756,502933,69125,52368,121493,0.580828554,4156262,2294963,6451225,48385,33350,81735,1,2,5853226,596,5253709,11106935
Can be emulated,Above average state,KARNATAKA,70-79,0,KARNATAKA,AP,29,B0101,Total,Acceptable Performance,0.253455108,90431,311435,401866,3793,4858,8651,31693,33117,64810,6777,6537,13314,0.697272431,696397,409164,1105561,5609,3224,8833,1,2,825298,592,760253,1585551
Can be emulated,Above average state,MAHARASHTRA,70-79,0,MAHARASHTRA,AP,27,B0101,Total,Acceptable Performance,0.278258366,247997,644074,892071,10017,13795,23812,54825,63049,117874,17604,17869,35473,0.673909022,1330760,829731,2160491,11237,8004,19241,1,2,1651186,596,1554723,3205909
Can be emulated,Above average state,KARNATAKA,80+,0,KARNATAKA,AP,29,B0101,Total,Acceptable Performance,0.160349267,25952,74316,100268,1220,1522,2742,8847,8711,17558,1737,1866,3603,0.805809918,320272,183609,503881,1614,946,2560,1,2,356808,592,268502,625310
Can be emulated,Above average state,MAHARASHTRA,80+,0,MAHARASHTRA,AP,27,B0101,Total,Acceptable Performance,0.183286816,62938,153376,216314,2644,3669,6313,13268,15433,28701,3992,4813,8805,0.784933663,557887,368487,926374,3499,3088,6587,1,2,638085,596,542109,1180194
Can be emulated,Above average state,KARNATAKA,Age not stated,0,KARNATAKA,AP,29,B0101,Total,Acceptable Performance,0.256003141,3548,8190,11738,238,326,564,1306,1330,2636,132,138,270,0.680617653,15455,15752,31207,264,292,556,1,2,20441,592,25410,45851
Can be emulated,Above average state,MAHARASHTRA,Age not stated,0,MAHARASHTRA,AP,27,B0101,Total,Acceptable Performance,0.382321632,47979,107892,155871,3071,4157,7228,10674,10384,21058,1368,1393,2761,0.559254935,128363,99643,228006,3144,3547,6691,1,2,188384,596,219312,407696
Can be emulated,Above average state,KARNATAKA,Oct-14,0,KARNATAKA,AP,29,B0101,Total,Acceptable Performance,0.034807621,81906,117773,199679,11672,12804,24476,50503,48221,98724,13812,15079,28891,0.942946802,2635138,2774214,5409352,26668,30068,56736,1,2,2781359,592,2955287,5736646
Can be emulated,Above average state,MAHARASHTRA,Oct-14,0,MAHARASHTRA,AP,27,B0101,Total,Acceptable Performance,0.032793316,147014,205007,352021,15739,19722,35461,57662,59601,117263,22055,22131,44186,0.952166535,4845543,5375522,10221065,44434,59419,103853,1,2,5072274,596,5662261,10734535
Can be emulated,Above average state,KARNATAKA,Total,0,KARNATAKA,AP,29,B0101,Total,Acceptable Performance,0.382962063,7047344,16349837,23397181,501269,603015,1104284,2263553,1668094,3931647,291584,252185,543769,0.5437849,20526159,12696541,33222700,954693,711124,1665817,1,2,30128640,592,30966657,61095297
Can be emulated,Above average state,MAHARASHTRA,Total,0,MAHARASHTRA,AP,27,B0101,Total,Acceptable Performance,0.389438485,13773576,29989314,43762890,908152,1223288,2131440,2588269,2239979,4828248,449158,387582,836740,0.560149754,37320274,25626181,62946455,1485743,1520858,3006601,1,2,54131277,596,58243056,112374333
Not considered,Above average state,ANDAMAN & NICOBAR ISLANDS,15-19,0,ANDAMAN & NICOBAR ISLANDS,AP,35,B0101,Total,Acceptable Performance,0.086447042,536,2319,2855,344,721,1065,418,762,1180,125,287,412,0.865348513,14681,13898,28579,4068,3909,7977,1,2,15760,593,17266,33026
Not considered,Above average state,ANDHRA PRADESH,15-19,0,ANDHRA PRADESH,AP,28,B0101,Total,Acceptable Performance,0.210955939,696083,1011341,1707424,136407,146338,282745,236990,220935,457925,47524,46329,93853,0.720870692,2916843,2917702,5834545,343584,381328,724912,1,1,3897440,635,4196307,8093747
Not considered,Above average state,CHHATTISGARH,15-19,0,CHHATTISGARH,AP,22,B0101,Total,Acceptable Performance,0.166642434,163222,270022,433244,122921,134441,257362,180573,155959,336532,79654,71254,150908,0.645869249,856942,822216,1679158,93073,111286,204359,1,1,1280391,660,1319451,2599842
Not considered,Above average state,DAMAN & DIU,15-19,0,DAMAN & DIU,AP,25,B0101,Total,Acceptable Performance,0.467849814,913,11398,12311,46,138,184,120,322,442,32,245,277,0.504826328,7010,6274,13284,722,793,1515,1,2,8075,588,18239,26314
Not considered,Above average state,GUJARAT,15-19,0,GUJARAT,AP,24,B0101,Total,Acceptable Performance,0.210303695,286631,946960,1233591,75277,110498,185775,266149,205856,472005,47537,41114,88651,0.69411517,2119333,1952180,4071513,131546,190669,322215,1,1,2719650,603,3146110,5865760
Not considered,Above average state,MEGHALAYA,15-19,0,MEGHALAYA,AP,17,B0101,Total,Acceptable Performance,0.183614971,22719,37174,59893,6158,8485,14643,11950,13990,25940,4989,5633,10622,0.704296295,121814,107919,229733,20970,19464,40434,1,1,161472,660,164716,326188
Not considered,Above average state,MIZORAM,15-19,0,MIZORAM,AP,15,B0101,Total,Acceptable Performance,0.19670482,8771,12934,21705,1512,1706,3218,3047,2655,5702,1703,1729,3432,0.720516934,40915,38589,79504,6685,6507,13192,1,1,54436,657,55907,110343
Not considered,Above average state,RAJASTHAN,15-19,0,RAJASTHAN,AP,8,B0101,Total,Acceptable Performance,0.171899518,435331,821945,1257276,258782,295364,554146,498605,357896,856501,196859,175037,371896,0.660149409,2293348,2534996,4828344,260329,381843,642172,1,2,3424143,569,3889874,7314017
Not considered,Above average state,TAMIL NADU,15-19,0,TAMIL NADU,AP,33,B0101,Total,Acceptable Performance,0.157544255,359002,626247,985249,58435,79996,138431,116045,141320,257365,18692,23617,42309,0.794536979,2530215,2438654,4968869,348065,417832,765897,1,1,3023954,610,3229838,6253792
Not considered,Above average state,TRIPURA,15-19,0,TRIPURA,AP,16,B0101,Total,Acceptable Performance,0.093773842,7737,25818,33555,11652,15461,27113,12459,14541,27000,4376,5163,9539,0.804113138,152121,135614,287735,53726,46242,99968,1,2,176693,582,181136,357829
Not considered,Above average state,ANDAMAN & NICOBAR ISLANDS,15-59,0,ANDAMAN & NICOBAR ISLANDS,AP,35,B0101,Total,Acceptable Performance,0.454836445,21152,98067,119219,3561,8945,12506,6626,12670,19296,1932,3081,5013,0.452421465,91188,27398,118586,24342,11292,35634,1,2,120898,593,141216,262114
Not considered,Above average state,ANDHRA PRADESH,15-59,0,ANDHRA PRADESH,AP,28,B0101,Total,Acceptable Performance,0.548509366,10393506,19083559,29477065,1364113,1248387,2612500,2761472,1992545,4754017,397889,269246,667135,0.350613812,13244483,5597613,18842096,1551435,1202340,2753775,1,1,26797350,635,26942963,53740313
Not considered,Above average state,CHHATTISGARH,15-59,0,CHHATTISGARH,AP,22,B0101,Total,Acceptable Performance,0.491543163,2434962,5102527,7537489,963634,914067,1877701,1737830,1110774,2848604,368920,197282,566202,0.285766689,3052231,1329812,4382043,391694,297153,688847,1,1,7593943,660,7740395,15334338
Not considered,Above average state,DAMAN & DIU,15-59,0,DAMAN & DIU,AP,25,B0101,Total,Acceptable Performance,0.639508341,11175,101727,112902,438,730,1168,1497,1765,3262,331,854,1185,0.335302614,47510,11686,59196,4458,2520,6978,1,2,60513,588,116032,176545
Not considered,Above average state,GUJARAT,15-59,0,GUJARAT,AP,24,B0101,Total,Acceptable Performance,0.49072654,3451736,15180501,18632237,465308,524939,990247,2407947,1098866,3506813,232306,140469,372775,0.407094812,12038699,3418152,15456851,611862,470555,1082417,1,1,18130688,603,19837988,37968676
Not considered,Above average state,MEGHALAYA,15-59,0,MEGHALAYA,AP,17,B0101,Total,Acceptable Performance,0.508751956,305192,531329,836521,41199,43730,84929,101341,79316,180657,23831,18744,42575,0.35548371,389237,195271,584508,74637,46294,120931,1,1,819601,660,824660,1644261
Not considered,Above average state,MIZORAM,15-59,0,MIZORAM,AP,15,B0101,Total,Acceptable Performance,0.568813128,140259,241951,382210,10412,10351,20763,30687,17188,47875,7626,5619,13245,0.340226775,153711,74902,228613,27430,19269,46699,1,1,332283,657,339660,671943
Not considered,Above average state,RAJASTHAN,15-59,0,RAJASTHAN,AP,8,B0101,Total,Acceptable Performance,0.485562217,5280505,13870686,19151191,1775301,1609454,3384755,4108643,2070794,6179437,897089,436284,1333373,0.323956852,8721958,4055312,12777270,1005617,923262,1928879,1,2,19008195,569,20433076,39441271
Not considered,Above average state,TAMIL NADU,15-59,0,TAMIL NADU,AP,33,B0101,Total,Acceptable Performance,0.526554779,8084752,16959754,25044506,661565,847050,1508615,1818994,1821692,3640686,331816,281073,612889,0.384014819,13640184,4624699,18264883,1917031,1207793,3124824,1,1,23875746,610,23687218,47562964
Not considered,Above average state,TRIPURA,15-59,0,TRIPURA,AP,16,B0101,Total,Acceptable Performance,0.418270983,174865,814248,989113,142543,113581,256124,158467,114141,272608,57495,26242,83737,0.431039688,762397,256911,1019308,342956,122281,465237,1,2,1153224,582,1211542,2364766
Not considered,Above average state,ANDAMAN & NICOBAR ISLANDS,20-24,0,ANDAMAN & NICOBAR ISLANDS,AP,35,B0101,Total,Acceptable Performance,0.316125556,1692,10041,11733,688,1911,2599,890,2116,3006,267,611,878,0.579226728,14738,6760,21498,6597,4187,10784,1,2,17587,593,19528,37115
Not considered,Above average state,ANDHRA PRADESH,20-24,0,ANDHRA PRADESH,AP,28,B0101,Total,Acceptable Performance,0.426601439,1299947,2169216,3469163,216308,231599,447907,384884,328553,713437,57040,47777,104817,0.472778229,2334526,1510151,3844677,437803,471602,909405,1,1,4076397,635,4055697,8132094
Not considered,Above average state,CHHATTISGARH,20-24,0,CHHATTISGARH,AP,22,B0101,Total,Acceptable Performance,0.40071446,322957,634549,957506,176087,195585,371672,281917,217031,498948,65661,43541,109202,0.344775909,525584,298257,823841,111940,112120,224060,1,1,1196119,660,1193378,2389497
Not considered,Above average state,DAMAN & DIU,20-24,0,DAMAN & DIU,AP,25,B0101,Total,Acceptable Performance,0.675979681,1541,24541,26082,88,208,296,209,435,644,58,300,358,0.298051006,8851,2649,11500,1230,913,2143,1,2,10659,588,27925,38584
Not considered,Above average state,GUJARAT,20-24,0,GUJARAT,AP,24,B0101,Total,Acceptable Performance,0.422950455,427371,2017588,2444959,90649,141107,231756,358916,254699,613615,40563,33121,73684,0.458154535,1907745,740719,2648464,161585,166040,327625,1,1,2734595,603,3046127,5780722
Not considered,Above average state,MEGHALAYA,20-24,0,MEGHALAYA,AP,17,B0101,Total,Acceptable Performance,0.395309671,42544,70124,112668,8951,10052,19003,18035,15684,33719,4658,4166,8824,0.45542293,80635,49166,129801,22198,16185,38383,1,1,145872,660,139140,285012
Not considered,Above average state,MIZORAM,20-24,0,MIZORAM,AP,15,B0101,Total,Acceptable Performance,0.442618255,17986,31458,49444,2433,2825,5258,5413,3937,9350,1583,1326,2909,0.447640276,31214,18791,50005,8336,6825,15161,1,1,56196,657,55512,111708
Not considered,Above average state,RAJASTHAN,20-24,0,RAJASTHAN,AP,8,B0101,Total,Acceptable Performance,0.414357191,739865,1922999,2662864,316691,381656,698347,656199,438386,1094585,150248,98834,249082,0.376560376,1502699,917264,2419963,277505,345679,623184,1,2,3049011,569,3377483,6426494
Not considered,Above average state,TAMIL NADU,20-24,0,TAMIL NADU,AP,33,B0101,Total,Acceptable Performance,0.393293627,826891,1694728,2521619,119600,168222,287822,221125,257836,478961,38299,42645,80944,0.519378721,2170424,1159595,3330019,540492,466313,1006805,1,1,3256739,610,3154804,6411543
Not considered,Above average state,TRIPURA,20-24,0,TRIPURA,AP,16,B0101,Total,Acceptable Performance,0.276099545,18003,85031,103034,23753,27961,51714,25194,25996,51190,8246,6986,15232,0.54590985,137955,65766,203721,78833,42232,121065,1,2,189398,582,183779,373177
Not considered,Above average state,ANDAMAN & NICOBAR ISLANDS,25-29,0,ANDAMAN & NICOBAR ISLANDS,AP,35,B0101,Total,Acceptable Performance,0.463616318,3147,16196,19343,828,2211,3039,1169,2658,3827,327,592,919,0.422630746,14849,2784,17633,5546,1855,7401,1,2,19492,593,22230,41722
Not considered,Above average state,ANDHRA PRADESH,25-29,0,ANDHRA PRADESH,AP,28,B0101,Total,Acceptable Performance,0.59116101,1650692,2959794,4610486,234018,213477,447495,441693,322062,763755,59832,39425,99257,0.29818275,1836932,488606,2325538,302244,210125,512369,1,1,3989149,635,3809887,7799036
Not considered,Above average state,CHHATTISGARH,25-29,0,CHHATTISGARH,AP,22,B0101,Total,Acceptable Performance,0.537971613,337440,769329,1106769,145126,150137,295263,250717,175040,425757,46866,22500,69366,0.221361979,373039,82369,455408,66872,41169,108041,1,1,1008062,660,1049238,2057300
Not considered,Above average state,DAMAN & DIU,25-29,0,DAMAN & DIU,AP,25,B0101,Total,Acceptable Performance,0.678701667,1813,20707,22520,78,134,212,208,315,523,54,120,174,0.300292336,9062,902,9964,974,415,1389,1,2,11137,588,22044,33181
Not considered,Above average state,GUJARAT,25-29,0,GUJARAT,AP,24,B0101,Total,Acceptable Performance,0.531598338,465320,2340893,2806213,74405,96870,171275,344108,192014,536122,30493,19990,50483,0.357277438,1671618,214386,1886004,108539,58852,167391,1,1,2511539,603,2767283,5278822
Not considered,Above average state,MEGHALAYA,25-29,0,MEGHALAYA,AP,17,B0101,Total,Acceptable Performance,0.559501116,50237,90355,140592,7755,8456,16211,17757,14105,31862,3758,2804,6562,0.287586407,54853,17412,72265,14058,6420,20478,1,1,126605,660,124676,251281
Not considered,Above average state,MIZORAM,25-29,0,MIZORAM,AP,15,B0101,Total,Acceptable Performance,0.600678092,21501,39976,61477,2238,2180,4418,5532,3377,8909,1273,838,2111,0.291647939,22650,7199,29849,5238,3215,8453,1,1,50956,657,51390,102346
Not considered,Above average state,RAJASTHAN,25-29,0,RAJASTHAN,AP,8,B0101,Total,Acceptable Performance,0.547301606,766345,2160896,2927241,272307,262320,534627,604907,324011,928918,116804,46259,163063,0.248532438,1097382,231893,1329275,164640,111680,276320,1,2,2585438,569,2763059,5348497
Not considered,Above average state,TAMIL NADU,25-29,0,TAMIL NADU,AP,33,B0101,Total,Acceptable Performance,0.548403706,1128796,2525627,3654423,127665,164029,291694,271658,283636,555294,48245,42931,91176,0.354583293,1977673,385180,2362853,433133,194512,627645,1,1,3426372,610,3237374,6663746
Not considered,Above average state,TRIPURA,25-29,0,TRIPURA,AP,16,B0101,Total,Acceptable Performance,0.432208142,23838,124906,148744,25776,22630,48406,26868,22225,49093,9573,4630,14203,0.383871521,108811,23298,132109,63245,17427,80672,1,2,169090,582,175059,344149
Not considered,Above average state,ANDAMAN & NICOBAR ISLANDS,30-34,0,ANDAMAN & NICOBAR ISLANDS,AP,35,B0101,Total,Acceptable Performance,0.531030429,3340,15630,18970,600,1507,2107,998,2055,3053,326,455,781,0.361643759,11700,1219,12919,3457,678,4135,1,2,16364,593,19359,35723
Not considered,Above average state,ANDHRA PRADESH,30-34,0,ANDHRA PRADESH,AP,28,B0101,Total,Acceptable Performance,0.661645585,1508664,2847856,4356520,192666,165583,358249,385770,262360,648130,50713,30633,81346,0.227565397,1338817,159558,1498375,150773,57703,208476,1,1,3283964,635,3300407,6584371
Not considered,Above average state,CHHATTISGARH,30-34,0,CHHATTISGARH,AP,22,B0101,Total,Acceptable Performance,0.587372415,348553,717562,1066115,131300,111876,243176,234829,134329,369158,39518,14712,54230,0.179363414,294135,31420,325555,41551,14127,55678,1,1,917035,660,898023,1815058
Not considered,Above average state,DAMAN & DIU,30-34,0,DAMAN & DIU,AP,25,B0101,Total,Acceptable Performance,0.687070867,1871,14640,16511,64,83,147,187,218,405,50,55,105,0.291706546,6609,401,7010,596,180,776,1,2,8717,588,15314,24031
Not considered,Above average state,GUJARAT,30-34,0,GUJARAT,AP,24,B0101,Total,Acceptable Performance,0.571036791,496152,2227995,2724147,63605,60725,124330,339846,131590,471436,26798,12880,39678,0.321823287,1440708,94559,1535267,68441,20280,88721,1,1,2303504,603,2467024,4770528
Not considered,Above average state,MEGHALAYA,30-34,0,MEGHALAYA,AP,17,B0101,Total,Acceptable Performance,0.636206415,42726,77935,120661,5120,5166,10286,13099,9488,22587,2553,1766,4319,0.221926952,35493,6597,42090,6847,1907,8754,1,1,93871,660,95786,189657
Not considered,Above average state,MIZORAM,30-34,0,MIZORAM,AP,15,B0101,Total,Acceptable Performance,0.666417725,20992,37902,58894,1477,1405,2882,4623,2371,6994,907,555,1462,0.237898024,17511,3513,21024,3146,1368,4514,1,1,44033,657,44341,88374
Not considered,Above average state,RAJASTHAN,30-34,0,RAJASTHAN,AP,8,B0101,Total,Acceptable Performance,0.590197352,765031,2022284,2787315,247841,191591,439432,570624,246710,817334,103551,29378,132929,0.208590117,898908,86197,985105,102770,34527,137297,1,2,2338114,569,2384569,4722683
Not considered,Above average state,TAMIL NADU,30-34,0,TAMIL NADU,AP,33,B0101,Total,Acceptable Performance,0.61930992,1107649,2493985,3601634,92665,117408,210073,243442,239824,483266,44291,34875,79166,0.283978499,1511429,140065,1651494,223179,57942,281121,1,1,2906811,610,2908749,5815560
Not considered,Above average state,TRIPURA,30-34,0,TRIPURA,AP,16,B0101,Total,Acceptable Performance,0.509608382,23948,122304,146252,21480,14723,36203,22623,14999,37622,8438,2619,11057,0.320771876,82749,9309,92058,46317,6834,53151,1,2,137758,582,149231,286989
Not considered,Above average state,ANDAMAN & NICOBAR ISLANDS,35-39,0,ANDAMAN & NICOBAR ISLANDS,AP,35,B0101,Total,Acceptable Performance,0.553437671,3633,14543,18176,484,1012,1496,1005,1632,2637,259,356,615,0.347542781,10775,639,11414,2398,304,2702,1,2,15672,593,17170,32842
Not considered,Above average state,ANDHRA PRADESH,35-39,0,ANDHRA PRADESH,AP,28,B0101,Total,Acceptable Performance,0.678674186,1592724,2823639,4416363,191319,153962,345281,394429,248067,642496,51227,29196,80423,0.210232939,1270447,97610,1368057,119666,27444,147110,1,1,3308827,635,3198512,6507339
Not considered,Above average state,CHHATTISGARH,35-39,0,CHHATTISGARH,AP,22,B0101,Total,Acceptable Performance,0.616608052,363741,733460,1097201,123777,101448,225225,228810,125305,354115,36391,12370,48761,0.15698258,259207,20130,279337,29622,7044,36666,1,1,888149,660,891265,1779414
Not considered,Above average state,DAMAN & DIU,35-39,0,DAMAN & DIU,AP,25,B0101,Total,Acceptable Performance,0.695805627,1827,11776,13603,66,63,129,250,147,397,45,46,91,0.279232737,5173,286,5459,432,92,524,1,2,7295,588,12255,19550
Not considered,Above average state,GUJARAT,35-39,0,GUJARAT,AP,24,B0101,Total,Acceptable Performance,0.594808839,496557,2085642,2582199,54195,42555,96750,309807,98167,407974,22829,9504,32333,0.303766564,1253697,65022,1318719,52311,11265,63576,1,1,2082890,603,2258335,4341225
Not considered,Above average state,MEGHALAYA,35-39,0,MEGHALAYA,AP,17,B0101,Total,Acceptable Performance,0.664275984,42319,73734,116053,4585,4079,8664,12465,8214,20679,2389,1370,3759,0.195843302,30213,4002,34215,4617,973,5590,1,1,87386,660,87320,174706
Not considered,Above average state,MIZORAM,35-39,0,MIZORAM,AP,15,B0101,Total,Acceptable Performance,0.717216512,19045,32870,51915,1100,862,1962,3542,1543,5085,682,385,1067,0.19779233,12298,2019,14317,1965,651,2616,1,1,35567,657,36817,72384
Not considered,Above average state,RAJASTHAN,35-39,0,RAJASTHAN,AP,8,B0101,Total,Acceptable Performance,0.61277974,738554,1917579,2656133,221455,155328,376783,522430,206752,729182,92303,23165,115468,0.192356371,779487,54294,833781,73942,16686,90628,1,2,2132774,569,2201790,4334564
Not considered,Above average state,TAMIL NADU,35-39,0,TAMIL NADU,AP,33,B0101,Total,Acceptable Performance,0.646129089,1301999,2469105,3771104,93812,104730,198542,272569,230854,503423,50212,33904,84116,0.253203828,1396471,81342,1477813,170059,26151,196210,1,1,3021251,610,2815205,5836456
Not considered,Above average state,TRIPURA,35-39,0,TRIPURA,AP,16,B0101,Total,Acceptable Performance,0.543631105,27517,124342,151859,20954,11230,32184,22570,11592,34162,8581,2029,10610,0.296092245,77623,5088,82711,39858,3389,43247,1,2,136291,582,143051,279342
Not considered,Above average state,ANDAMAN & NICOBAR ISLANDS,40-49,0,ANDAMAN & NICOBAR ISLANDS,AP,35,B0101,Total,Acceptable Performance,0.599237094,5859,24460,30319,457,1117,1574,1361,2180,3541,402,465,867,0.313641395,14891,978,15869,1773,237,2010,1,2,22513,593,28083,50596
Not considered,Above average state,ANDHRA PRADESH,40-49,0,ANDHRA PRADESH,AP,28,B0101,Total,Acceptable Performance,0.682903966,2286170,4581619,6867789,250908,221680,472588,561864,381793,943657,74706,45644,120350,0.211295666,1964971,159975,2124946,126901,30327,157228,1,1,4887711,635,5169031,10056742
Not considered,Above average state,CHHATTISGARH,40-49,0,CHHATTISGARH,AP,22,B0101,Total,Acceptable Performance,0.629534853,586380,1246150,1832530,179288,146604,325892,358822,192156,550978,58166,19200,77366,0.154608137,418183,31870,450053,33163,7263,40426,1,1,1421551,660,1489376,2910927
Not considered,Above average state,DAMAN & DIU,40-49,0,DAMAN & DIU,AP,25,B0101,Total,Acceptable Performance,0.671217537,2275,13310,15585,68,72,140,326,197,523,52,59,111,0.301477238,6533,467,7000,421,89,510,1,2,9186,588,14033,23219
Not considered,Above average state,GUJARAT,40-49,0,GUJARAT,AP,24,B0101,Total,Acceptable Performance,0.594667531,829592,3439817,4269409,73056,49993,123049,500271,133903,634174,37344,13607,50951,0.309904368,2106534,118421,2224955,62252,13373,75625,1,1,3473741,603,3705748,7179489
Not considered,Above average state,MEGHALAYA,40-49,0,MEGHALAYA,AP,17,B0101,Total,Acceptable Performance,0.691583043,68311,117424,185735,5938,5157,11095,18724,11634,30358,3535,1909,5444,0.175108447,41575,5453,47028,4397,916,5313,1,1,132145,660,136420,268565
Not considered,Above average state,MIZORAM,40-49,0,MIZORAM,AP,15,B0101,Total,Acceptable Performance,0.74920749,31386,52042,83428,1139,920,2059,5186,1970,7156,872,487,1359,0.174325356,16913,2499,19412,1465,486,1951,1,1,54357,657,56998,111355
Not considered,Above average state,RAJASTHAN,40-49,0,RAJASTHAN,AP,8,B0101,Total,Acceptable Performance,0.620857234,1169476,3102493,4271969,309654,213010,522664,796640,304075,1100715,141208,35398,176606,0.193506123,1238007,93462,1331469,86772,19827,106599,1,2,3345331,569,3535428,6880759
Not considered,Above average state,TAMIL NADU,40-49,0,TAMIL NADU,AP,33,B0101,Total,Acceptable Performance,0.655232317,2085937,4320443,6406380,113523,142609,256132,424915,399102,824017,78137,60179,138316,0.246342101,2263515,145037,2408552,146581,26892,173473,1,1,4852504,610,4924761,9777265
Not considered,Above average state,TRIPURA,40-49,0,TRIPURA,AP,16,B0101,Total,Acceptable Performance,0.569447571,47268,205692,252960,27392,14171,41563,32619,15406,48025,12108,2731,14839,0.289036964,121415,6981,128396,45173,3545,48718,1,2,213410,582,230810,444220
Not considered,Above average state,ANDAMAN & NICOBAR ISLANDS,5-Sep,0,ANDAMAN & NICOBAR ISLANDS,AP,35,B0101,Total,Acceptable Performance,0.012543508,180,202,382,49,44,93,108,113,221,12,5,17,0.979641426,14642,15192,29834,308,307,615,1,2,14942,593,15512,30454
Not considered,Above average state,ANDHRA PRADESH,5-Sep,0,ANDHRA PRADESH,AP,28,B0101,Total,Acceptable Performance,0.010357958,33912,41747,75659,9109,9874,18983,34184,35329,69513,4308,4347,8655,0.978940594,3471630,3678975,7150605,20029,21589,41618,1,1,3544034,635,3760398,7304432
Not considered,Above average state,CHHATTISGARH,5-Sep,0,CHHATTISGARH,AP,22,B0101,Total,Acceptable Performance,0.003613945,4648,5322,9970,1521,1577,3098,6058,5754,11812,9596,9020,18616,0.985356454,1334377,1383983,2718360,5882,6404,12286,1,1,1354679,660,1404079,2758758
Not considered,Above average state,DAMAN & DIU,5-Sep,0,DAMAN & DIU,AP,25,B0101,Total,Acceptable Performance,0.004701178,37,50,87,7,7,14,14,15,29,1,0,1,0.993677726,8626,9763,18389,81,68,149,1,2,8678,588,9828,18506
Not considered,Above average state,GUJARAT,5-Sep,0,GUJARAT,AP,24,B0101,Total,Acceptable Performance,0.00779597,16983,28513,45496,2921,3607,6528,15757,16489,32246,4689,4842,9531,0.98504533,2672006,3076557,5748563,13900,16794,30694,1,1,2709435,603,3126401,5835836
Not considered,Above average state,MEGHALAYA,5-Sep,0,MEGHALAYA,AP,17,B0101,Total,Acceptable Performance,0.012192239,2277,2468,4745,983,951,1934,2527,2497,5024,975,946,1921,0.96996264,185818,191674,377492,4038,3946,7984,1,1,191597,660,197585,389182
Not considered,Above average state,MIZORAM,5-Sep,0,MIZORAM,AP,15,B0101,Total,Acceptable Performance,0.003803443,223,225,448,54,52,106,176,174,350,353,342,695,0.987324685,57148,59147,116295,971,954,1925,1,1,57900,657,59888,117788
Not considered,Above average state,RAJASTHAN,5-Sep,0,RAJASTHAN,AP,8,B0101,Total,Acceptable Performance,0.005145014,19200,22180,41380,4972,4837,9809,21462,19295,40757,23020,21519,44539,0.984249642,3720183,4195879,7916062,19748,23123,42871,1,2,3783865,569,4258873,8042738
Not considered,Above average state,TAMIL NADU,5-Sep,0,TAMIL NADU,AP,33,B0101,Total,Acceptable Performance,0.006868717,17189,20941,38130,6298,6748,13046,23897,24308,48205,1003,1002,2005,0.984086481,2657873,2805042,5462915,16088,17411,33499,1,1,2699962,610,2851293,5551255
Not considered,Above average state,TRIPURA,5-Sep,0,TRIPURA,AP,16,B0101,Total,Acceptable Performance,0.002946097,418,577,995,302,323,625,676,714,1390,152,156,308,0.992026293,163948,171094,335042,2072,2155,4227,1,2,165194,582,172541,337735
Not considered,Above average state,ANDAMAN & NICOBAR ISLANDS,50-59,0,ANDAMAN & NICOBAR ISLANDS,AP,35,B0101,Total,Acceptable Performance,0.573271148,2945,14878,17823,160,466,626,785,1267,2052,226,315,541,0.343325828,9554,1120,10674,503,122,625,1,2,13510,593,17580,31090
Not considered,Above average state,ANDHRA PRADESH,50-59,0,ANDHRA PRADESH,AP,28,B0101,Total,Acceptable Performance,0.616617918,1359226,2690094,4049320,142487,115748,258235,355842,228775,584617,56847,30242,87089,0.281096771,1581947,264011,1845958,70464,23811,94275,1,1,3353862,635,3213122,6566984
Not considered,Above average state,CHHATTISGARH,50-59,0,CHHATTISGARH,AP,22,B0101,Total,Acceptable Performance,0.585829546,312669,731455,1044124,85135,73976,159111,202162,110954,313116,42664,13705,56369,0.206862481,325141,43550,368691,15473,4144,19617,1,1,882636,660,899664,1782300
Not considered,Above average state,DAMAN & DIU,50-59,0,DAMAN & DIU,AP,25,B0101,Total,Acceptable Performance,0.539173667,935,5355,6290,28,32,60,197,131,328,40,29,69,0.426795817,4272,707,4979,83,38,121,1,2,5444,588,6222,11666
Not considered,Above average state,GUJARAT,50-59,0,GUJARAT,AP,24,B0101,Total,Acceptable Performance,0.541171853,450113,2121606,2571719,34121,23191,57312,288850,82637,371487,26742,10253,36995,0.372870481,1539064,232865,1771929,27188,10076,37264,1,1,2304769,603,2447361,4752130
Not considered,Above average state,MEGHALAYA,50-59,0,MEGHALAYA,AP,17,B0101,Total,Acceptable Performance,0.677982157,36336,64583,100919,2692,2335,5027,9311,6201,15512,1949,1096,3045,0.197350388,24654,4722,29376,1550,429,1979,1,1,72250,660,76602,148852
Not considered,Above average state,MIZORAM,50-59,0,MIZORAM,AP,15,B0101,Total,Acceptable Performance,0.733723967,20578,34769,55347,513,453,966,3344,1335,4679,606,299,905,0.192250076,12210,2292,14502,595,217,812,1,1,36738,657,38695,75433
Not considered,Above average state,RAJASTHAN,50-59,0,RAJASTHAN,AP,8,B0101,Total,Acceptable Performance,0.586371161,665903,1922490,2588393,148571,110185,258756,459238,192964,652202,96116,28213,124329,0.237714524,912127,137206,1049333,39659,13020,52679,1,2,2133384,569,2280873,4414257
Not considered,Above average state,TAMIL NADU,50-59,0,TAMIL NADU,AP,33,B0101,Total,Acceptable Performance,0.603135496,1274478,2829619,4104097,55865,70056,125921,269240,269120,538360,53940,42922,96862,0.303512682,1790457,274826,2065283,55522,18151,73673,1,1,3388115,610,3416487,6804602
Not considered,Above average state,TRIPURA,50-59,0,TRIPURA,AP,16,B0101,Total,Acceptable Performance,0.547226403,26554,126155,152709,11536,7405,18941,16134,9382,25516,6173,2084,8257,0.331749445,81723,10855,92578,15804,2612,18416,1,2,130584,582,148476,279060
Not considered,Above average state,ANDAMAN & NICOBAR ISLANDS,60-69,0,ANDAMAN & NICOBAR ISLANDS,AP,35,B0101,Total,Acceptable Performance,0.260209613,525,3795,4320,50,157,207,281,622,903,100,196,296,0.667570172,6459,4624,11083,141,130,271,1,2,7365,593,9237,16602
Not considered,Above average state,ANDHRA PRADESH,60-69,0,ANDHRA PRADESH,AP,28,B0101,Total,Acceptable Performance,0.419640587,737382,1515119,2252501,74925,76822,151747,216068,185884,401952,50213,34141,84354,0.489760681,1843904,784980,2628884,57473,31777,89250,1,1,2847567,635,2520124,5367691
Not considered,Above average state,CHHATTISGARH,60-69,0,CHHATTISGARH,AP,22,B0101,Total,Acceptable Performance,0.378753272,143159,340718,483877,38005,38096,76101,110235,76666,186901,37693,17470,55163,0.431771857,393173,158438,551611,10146,5376,15522,1,1,684260,660,593292,1277552
Not considered,Above average state,DAMAN & DIU,60-69,0,DAMAN & DIU,AP,25,B0101,Total,Acceptable Performance,0.277722702,365,1596,1961,11,13,24,100,70,170,24,22,46,0.69168673,3413,1471,4884,43,19,62,1,2,3902,588,3159,7061
Not considered,Above average state,GUJARAT,60-69,0,GUJARAT,AP,24,B0101,Total,Acceptable Performance,0.357425434,182719,853037,1035756,13783,10440,24223,132061,50797,182858,18176,10070,28246,0.569725422,1163607,487357,1650964,14381,8394,22775,1,1,1496563,603,1401261,2897824
Not considered,Above average state,MEGHALAYA,60-69,0,MEGHALAYA,AP,17,B0101,Total,Acceptable Performance,0.526884207,16173,29393,45566,1185,1071,2256,4550,3589,8139,1173,758,1931,0.356675378,21683,9163,30846,1041,557,1598,1,1,43579,660,42903,86482
Not considered,Above average state,MIZORAM,60-69,0,MIZORAM,AP,15,B0101,Total,Acceptable Performance,0.552816728,7844,14628,22472,245,173,418,1776,985,2761,510,275,785,0.3599508,10049,4583,14632,309,160,469,1,1,20179,657,20471,40650
Not considered,Above average state,RAJASTHAN,60-69,0,RAJASTHAN,AP,8,B0101,Total,Acceptable Performance,0.389434139,304130,876056,1180186,62723,56555,119278,238410,142392,380802,76304,37640,113944,0.447311101,938176,417407,1355583,20317,11998,32315,1,2,1557020,569,1473495,3030515
Not considered,Above average state,TAMIL NADU,60-69,0,TAMIL NADU,AP,33,B0101,Total,Acceptable Performance,0.430571592,632916,1369663,2002579,26150,34453,60603,151436,173953,325389,36921,33119,70040,0.484407796,1555254,697716,2252970,29170,18091,47261,1,1,2376527,610,2274451,4650978
Not considered,Above average state,TRIPURA,60-69,0,TRIPURA,AP,16,B0101,Total,Acceptable Performance,0.344945677,9019,48797,57816,4620,3744,8364,7538,5979,13517,3167,1916,5083,0.544081762,63230,27963,91193,5748,2621,8369,1,2,82954,582,84655,167609
Not considered,Above average state,ANDAMAN & NICOBAR ISLANDS,60+,0,ANDAMAN & NICOBAR ISLANDS,AP,35,B0101,Total,Acceptable Performance,0.219988987,688,4905,5593,60,203,263,359,860,1219,127,273,400,0.716331026,10061,8151,18212,190,173,363,1,2,11235,593,14189,25424
Not considered,Above average state,ANDHRA PRADESH,60+,0,ANDHRA PRADESH,AP,28,B0101,Total,Acceptable Performance,0.350862701,903805,2000721,2904526,89906,98165,188071,266913,254236,521149,64029,50633,114662,0.572332214,3137166,1600738,4737904,74710,44571,119281,1,1,4371913,635,3906328,8278241
Not considered,Above average state,CHHATTISGARH,60+,0,CHHATTISGARH,AP,22,B0101,Total,Acceptable Performance,0.316596213,180036,454394,634430,46639,49428,96067,139553,106798,246351,52106,28994,81100,0.519997665,704055,337973,1042028,13934,7925,21859,1,1,1075750,660,928159,2003909
Not considered,Above average state,DAMAN & DIU,60+,0,DAMAN & DIU,AP,25,B0101,Total,Acceptable Performance,0.225772379,453,2112,2565,12,15,27,119,91,210,28,29,57,0.750726168,5888,2641,8529,55,26,81,1,2,6488,588,4873,11361
Not considered,Above average state,GUJARAT,60+,0,GUJARAT,AP,24,B0101,Total,Acceptable Performance,0.293886485,246664,1160041,1406705,18020,14414,32434,173642,74984,248626,26327,16920,43247,0.64513589,2094325,993656,3087981,20195,12056,32251,1,1,2540958,603,2245601,4786559
Not considered,Above average state,MEGHALAYA,60+,0,MEGHALAYA,AP,17,B0101,Total,Acceptable Performance,0.461022879,22475,41562,64037,1622,1544,3166,6319,5388,11707,1667,1229,2896,0.433845445,41502,18760,60262,1421,757,2178,1,1,71963,660,66939,138902
Not considered,Above average state,MIZORAM,60+,0,MIZORAM,AP,15,B0101,Total,Acceptable Performance,0.434545666,10065,19757,29822,316,248,564,2439,1635,4074,863,583,1446,0.485020691,20916,12370,33286,410,226,636,1,1,34283,657,34345,68628
Not considered,Above average state,RAJASTHAN,60+,0,RAJASTHAN,AP,8,B0101,Total,Acceptable Performance,0.308084993,391507,1183466,1574973,77162,74270,151432,303404,204667,508071,107786,66589,174375,0.558419784,1877178,977541,2854719,28234,17556,45790,1,2,2679875,569,2432263,5112138
Not considered,Above average state,TAMIL NADU,60+,0,TAMIL NADU,AP,33,B0101,Total,Acceptable Performance,0.363447264,828054,1901347,2729401,33238,45763,79001,200892,250497,451389,50196,50592,100788,0.563024801,2769390,1458790,4228180,38028,23831,61859,1,1,3848532,610,3661226,7509758
Not considered,Above average state,TRIPURA,60+,0,TRIPURA,AP,16,B0101,Total,Acceptable Performance,0.285079297,12537,70006,82543,6076,5460,11536,10325,9467,19792,4436,3236,7672,0.620068107,120326,59211,179537,7780,3690,11470,1,2,147624,582,141920,289544
Not considered,Above average state,ANDAMAN & NICOBAR ISLANDS,70-79,0,ANDAMAN & NICOBAR ISLANDS,AP,35,B0101,Total,Acceptable Performance,0.150102378,111,842,953,6,30,36,63,184,247,24,64,88,0.797133407,2478,2583,5061,29,30,59,1,2,2676,593,3673,6349
Not considered,Above average state,ANDHRA PRADESH,70-79,0,ANDHRA PRADESH,AP,28,B0101,Total,Acceptable Performance,0.24486968,128669,399355,528024,11461,17593,29054,39247,56097,95344,11475,13777,25252,0.699204256,916739,590988,1507727,14341,10741,25082,1,1,1096130,635,1060217,2156347
Not considered,Above average state,CHHATTISGARH,70-79,0,CHHATTISGARH,AP,22,B0101,Total,Acceptable Performance,0.224682993,29428,91806,121234,6655,8895,15550,23480,24183,47663,11798,8906,20704,0.648612434,225078,124899,349977,2912,1855,4767,1,1,289784,660,249794,539578
Not considered,Above average state,DAMAN & DIU,70-79,0,DAMAN & DIU,AP,25,B0101,Total,Acceptable Performance,0.133438486,69,354,423,0,2,2,14,19,33,2,6,8,0.85362776,1807,899,2706,9,5,14,1,2,1892,588,1278,3170
Not considered,Above average state,GUJARAT,70-79,0,GUJARAT,AP,24,B0101,Total,Acceptable Performance,0.21696414,49144,241517,290661,3164,2915,6079,32394,18643,51037,6399,5189,11588,0.736289378,637873,348514,986387,4268,2637,6905,1,1,725810,603,613863,1339673
Not considered,Above average state,MEGHALAYA,70-79,0,MEGHALAYA,AP,17,B0101,Total,Acceptable Performance,0.38508059,4877,9195,14072,332,346,678,1359,1336,2695,378,346,724,0.5213584,12920,6132,19052,278,127,405,1,1,19534,660,17009,36543
Not considered,Above average state,MIZORAM,70-79,0,MIZORAM,AP,15,B0101,Total,Acceptable Performance,0.31195718,1885,4293,6178,56,62,118,567,533,1100,282,243,525,0.605988689,7078,4923,12001,60,37,97,1,1,9812,657,9992,19804
Not considered,Above average state,RAJASTHAN,70-79,0,RAJASTHAN,AP,8,B0101,Total,Acceptable Performance,0.217014927,70397,253947,324344,11526,14520,26046,53656,51826,105482,26018,23063,49081,0.679568705,638472,377191,1015663,6021,4159,10180,1,2,788543,569,706027,1494570
Not considered,Above average state,TAMIL NADU,70-79,0,TAMIL NADU,AP,33,B0101,Total,Acceptable Performance,0.28613548,162675,443008,605683,5741,9410,15151,40393,62618,103011,10998,14092,25090,0.653347317,855791,527195,1382986,7324,4703,12027,1,1,1069857,610,1046913,2116770
Not considered,Above average state,TRIPURA,70-79,0,TRIPURA,AP,16,B0101,Total,Acceptable Performance,0.230615217,2692,16313,19005,1116,1335,2451,2134,2632,4766,978,977,1955,0.687829147,36812,19872,56684,1446,798,2244,1,2,42616,582,39794,82410
Not considered,Above average state,ANDAMAN & NICOBAR ISLANDS,80+,0,ANDAMAN & NICOBAR ISLANDS,AP,35,B0101,Total,Acceptable Performance,0.129397493,52,268,320,4,16,20,15,54,69,3,13,16,0.836231298,1124,944,2068,20,13,33,1,2,1194,593,1279,2473
Not considered,Above average state,ANDHRA PRADESH,80+,0,ANDHRA PRADESH,AP,28,B0101,Total,Acceptable Performance,0.164413295,37754,86247,124001,3520,3750,7270,11598,12255,23853,2341,2715,5056,0.797256176,376523,224770,601293,2896,2053,4949,1,1,428216,635,325987,754203
Not considered,Above average state,CHHATTISGARH,80+,0,CHHATTISGARH,AP,22,B0101,Total,Acceptable Performance,0.156971608,7449,21870,29319,1979,2437,4416,5838,5949,11787,2615,2618,5233,0.751904657,85804,54636,140440,876,694,1570,1,1,101706,660,85073,186779
Not considered,Above average state,DAMAN & DIU,80+,0,DAMAN & DIU,AP,25,B0101,Total,Acceptable Performance,0.160176991,19,162,181,1,0,1,5,2,7,2,1,3,0.830973451,668,271,939,3,2,5,1,2,694,588,436,1130
Not considered,Above average state,GUJARAT,80+,0,GUJARAT,AP,24,B0101,Total,Acceptable Performance,0.146227566,14801,65487,80288,1073,1059,2132,9187,5544,14731,1752,1661,3413,0.820726985,292845,157785,450630,1546,1025,2571,1,1,318585,603,230477,549062
Not considered,Above average state,MEGHALAYA,80+,0,MEGHALAYA,AP,17,B0101,Total,Acceptable Performance,0.277067456,1425,2974,4399,105,127,232,410,463,873,116,125,241,0.652768155,6899,3465,10364,102,73,175,1,1,8850,660,7027,15877
Not considered,Above average state,MIZORAM,80+,0,MIZORAM,AP,15,B0101,Total,Acceptable Performance,0.143381453,336,836,1172,15,13,28,96,117,213,71,65,136,0.813922192,3789,2864,6653,41,29,70,1,1,4292,657,3882,8174
Not considered,Above average state,RAJASTHAN,80+,0,RAJASTHAN,AP,8,B0101,Total,Acceptable Performance,0.119994276,16980,53463,70443,2913,3195,6108,11338,10449,21787,5464,5886,11350,0.823559372,300530,182943,483473,1896,1399,3295,1,2,334312,569,252741,587053
Not considered,Above average state,TAMIL NADU,80+,0,TAMIL NADU,AP,33,B0101,Total,Acceptable Performance,0.163257908,32463,88676,121139,1347,1900,3247,9063,13926,22989,2277,3381,5658,0.798134796,358345,233879,592224,1534,1037,2571,1,1,402148,610,339862,742010
Not considered,Above average state,TRIPURA,80+,0,TRIPURA,AP,16,B0101,Total,Acceptable Performance,0.144769133,826,4896,5722,340,381,721,653,856,1509,291,343,634,0.801012018,20284,11376,31660,586,271,857,1,2,22054,582,17471,39525
Not considered,Above average state,ANDAMAN & NICOBAR ISLANDS,Age not stated,0,ANDAMAN & NICOBAR ISLANDS,AP,35,B0101,Total,Acceptable Performance,0.269021739,18,81,99,3,10,13,3,15,18,2,4,6,0.66576087,150,95,245,23,12,35,1,2,173,593,195,368
Not considered,Above average state,ANDHRA PRADESH,Age not stated,0,ANDHRA PRADESH,AP,28,B0101,Total,Acceptable Performance,0.325286383,89455,161481,250936,10714,10898,21612,28883,25748,54631,3062,2720,5782,0.596400715,262345,197737,460082,7813,7145,14958,1,1,383745,635,387686,771431
Not considered,Above average state,CHHATTISGARH,Age not stated,0,CHHATTISGARH,AP,22,B0101,Total,Acceptable Performance,0.255721393,1821,4090,5911,512,598,1110,990,921,1911,272,182,454,0.641964093,7925,6914,14839,240,213,453,1,1,11008,660,12107,23115
Not considered,Above average state,DAMAN & DIU,Age not stated,0,DAMAN & DIU,AP,25,B0101,Total,Acceptable Performance,0.54494382,17,177,194,1,1,2,4,11,15,0,0,0,0.412921348,87,60,147,2,4,6,1,2,108,588,248,356
Not considered,Above average state,GUJARAT,Age not stated,0,GUJARAT,AP,24,B0101,Total,Acceptable Performance,0.318676626,14396,61718,76114,1808,1937,3745,10011,6466,16477,914,762,1676,0.60531979,87977,56600,144577,1697,1536,3233,1,1,113298,603,125546,238844
Not considered,Above average state,MEGHALAYA,Age not stated,0,MEGHALAYA,AP,17,B0101,Total,Acceptable Performance,0.376556017,632,1546,2178,95,145,240,223,276,499,36,44,80,0.523340249,1564,1463,3027,49,43,92,1,1,2455,660,3329,5784
Not considered,Above average state,MIZORAM,Age not stated,0,MIZORAM,AP,15,B0101,Total,Acceptable Performance,0.32385466,70,135,205,6,5,11,18,19,37,4,9,13,0.597156398,162,216,378,10,11,21,1,1,254,657,379,633
Not considered,Above average state,RAJASTHAN,Age not stated,0,RAJASTHAN,AP,8,B0101,Total,Acceptable Performance,0.294753006,23666,55800,79466,7619,6478,14097,19875,10209,30084,4536,2363,6899,0.568070712,84010,69143,153153,3304,3186,6490,1,2,132087,569,137515,269602
Not considered,Above average state,TAMIL NADU,Age not stated,0,TAMIL NADU,AP,33,B0101,Total,Acceptable Performance,0.252032034,5758,11079,16837,481,550,1031,1697,1824,3521,223,209,432,0.688795749,24457,21558,46015,535,612,1147,1,1,32135,610,34670,66805
Not considered,Above average state,TRIPURA,Age not stated,0,TRIPURA,AP,16,B0101,Total,Acceptable Performance,0.225866337,73,292,365,33,31,64,57,53,110,13,8,21,0.693069307,606,514,1120,94,31,125,1,2,749,582,867,1616
Not considered,Above average state,ANDAMAN & NICOBAR ISLANDS,Oct-14,0,ANDAMAN & NICOBAR ISLANDS,AP,35,B0101,Total,Acceptable Performance,0.018436071,253,364,617,77,90,167,147,198,345,39,51,90,0.96856605,15910,16505,32415,710,784,1494,1,2,16349,593,17118,33467
Not considered,Above average state,ANDHRA PRADESH,Oct-14,0,ANDHRA PRADESH,AP,28,B0101,Total,Acceptable Performance,0.040137559,156619,172573,329192,31689,29329,61018,77439,70675,148114,21835,20035,41870,0.936698167,3736818,3945601,7682419,43866,46591,90457,1,1,3992711,635,4208884,8201595
Not considered,Above average state,CHHATTISGARH,Oct-14,0,CHHATTISGARH,AP,22,B0101,Total,Acceptable Performance,0.01869409,22793,31121,53914,18692,17972,36664,37496,31786,69282,49278,44901,94179,0.924627594,1313261,1353377,2666638,17315,19803,37118,1,1,1422828,660,1461185,2884013
Not considered,Above average state,DAMAN & DIU,Oct-14,0,DAMAN & DIU,AP,25,B0101,Total,Acceptable Performance,0.039662837,139,548,687,5,19,24,18,41,59,4,14,18,0.955891692,7860,8697,16557,107,135,242,1,2,8021,588,9300,17321
Not considered,Above average state,GUJARAT,Oct-14,0,GUJARAT,AP,24,B0101,Total,Acceptable Performance,0.033307396,67900,136922,204822,17226,19665,36891,73392,52976,126368,24169,20445,44614,0.938888144,2700150,3073491,5773641,32487,40914,73401,1,1,2865611,603,3283834,6149445
Not considered,Above average state,MEGHALAYA,Oct-14,0,MEGHALAYA,AP,17,B0101,Total,Acceptable Performance,0.03683685,5479,8615,14094,2210,2592,4802,5415,6059,11474,3521,3690,7211,0.91432701,174718,175109,349827,5905,5663,11568,1,1,189133,660,193473,382606
Not considered,Above average state,MIZORAM,Oct-14,0,MIZORAM,AP,15,B0101,Total,Acceptable Performance,0.02004599,1108,1237,2345,233,249,482,778,610,1388,1296,1256,2552,0.946273326,54273,56423,110696,1815,1867,3682,1,1,57455,657,59526,116981
Not considered,Above average state,RAJASTHAN,Oct-14,0,RAJASTHAN,AP,8,B0101,Total,Acceptable Performance,0.02517243,99553,111405,210958,54366,47988,102354,155181,101720,256901,133752,120099,253851,0.913882412,3561336,4097472,7658808,65358,77566,142924,1,2,3949822,569,4430696,8380518
Not considered,Above average state,TAMIL NADU,Oct-14,0,TAMIL NADU,AP,33,B0101,Total,Acceptable Performance,0.018341746,45234,68073,113307,11071,12653,23724,36644,38900,75544,3354,3687,7041,0.968289679,2903325,3078330,5981655,30023,35120,65143,1,1,2988557,610,3188990,6177547
Not considered,Above average state,TRIPURA,Oct-14,0,TRIPURA,AP,16,B0101,Total,Acceptable Performance,0.011191255,1245,2758,4003,1724,1899,3623,2308,2354,4662,1128,1074,2202,0.969618944,170008,176815,346823,7964,8211,16175,1,2,174689,582,183001,357690
Not considered,Above average state,ANDAMAN & NICOBAR ISLANDS,Total,0,ANDAMAN & NICOBAR ISLANDS,AP,35,B0101,Total,Acceptable Performance,0.330836274,22291,103619,125910,3750,9292,13042,7243,13856,21099,2112,3414,5526,0.5992049,146064,81982,228046,25573,12568,38141,1,2,177710,593,202871,380581
Not considered,Above average state,ANDHRA PRADESH,Total,0,ANDHRA PRADESH,AP,28,B0101,Total,Acceptable Performance,0.390601496,11577297,21460081,33037378,1505531,1396653,2902184,3168891,2378533,5547424,491123,346981,838104,0.533902296,26901320,18256551,45157871,1697853,1322236,3020089,1,1,42138631,635,42442146,84580777
Not considered,Above average state,CHHATTISGARH,Total,0,CHHATTISGARH,AP,22,B0101,Total,Acceptable Performance,0.322632614,2644260,5597454,8241714,1030998,983642,2014640,1921927,1256033,3177960,480172,280379,760551,0.523189251,7665944,5699029,13364973,429065,331498,760563,1,1,12712303,660,12832895,25545198
Not considered,Above average state,DAMAN & DIU,Total,0,DAMAN & DIU,AP,25,B0101,Total,Acceptable Performance,0.478669829,11821,104614,116435,463,772,1235,1652,1923,3575,364,897,1261,0.501449144,79109,42867,121976,4703,2753,7456,1,2,92946,588,150301,243247
Not considered,Above average state,GUJARAT,Total,0,GUJARAT,AP,24,B0101,Total,Acceptable Performance,0.336953636,3797679,16567695,20365374,505283,564562,1069845,2680749,1249781,3930530,288405,183438,471843,0.59020726,22181599,13490346,35671945,680141,541855,1221996,1,1,28948432,603,31491260,60439692
Not considered,Above average state,MEGHALAYA,Total,0,MEGHALAYA,AP,17,B0101,Total,Acceptable Performance,0.310619979,336055,585520,921575,46109,48962,95071,115825,93536,209361,30030,24653,54683,0.600383095,993147,788123,1781270,86050,56703,142753,1,1,1475057,660,1491832,2966889
Not considered,Above average state,MIZORAM,Total,0,MIZORAM,AP,15,B0101,Total,Acceptable Performance,0.378260782,151725,263305,415030,11021,10905,21926,34098,19626,53724,10142,7809,17951,0.556414201,345902,264599,610501,30636,22327,52963,1,1,541867,657,555339,1097206
Not considered,Above average state,RAJASTHAN,Total,0,RAJASTHAN,AP,8,B0101,Total,Acceptable Performance,0.307198368,5814431,15243537,21057968,1919420,1743027,3662447,4608565,2406685,7015250,1166183,646854,1813037,0.564012597,21408261,17253921,38662182,1122261,1044693,2166954,1,2,32997440,569,35550997,68548437
Not considered,Above average state,TAMIL NADU,Total,0,TAMIL NADU,AP,33,B0101,Total,Acceptable Performance,0.387294959,8980987,18961194,27942181,712653,912764,1625417,2082124,2137221,4219345,386592,336563,723155,0.544199103,24559352,14702997,39262349,2001705,1284767,3286472,1,1,36009055,610,36137975,72147030
Not considered,Above average state,TRIPURA,Total,0,TRIPURA,AP,16,B0101,Total,Acceptable Performance,0.293152785,189138,887881,1077019,150678,121294,271972,171833,126729,298562,63224,30716,93940,0.600012466,1375346,829050,2204396,360866,136368,497234,1,2,1799541,582,1874376,3673917
Optimum Performing/Ideal role models,Above average state,HIMACHAL PRADESH,15-19,0,HIMACHAL PRADESH,AP,2,B0101,Total,Acceptable Performance,0.09302518,20281,39298,59579,22969,27969,50938,34028,32229,66257,36964,38445,75409,0.685781023,212459,226757,439216,27926,34202,62128,1,1,303732,696,336729,640461
Optimum Performing/Ideal role models,Above average state,SIKKIM,15-19,0,SIKKIM,AP,11,B0101,Total,Acceptable Performance,0.162660412,3860,7028,10888,1108,1388,2496,3035,3184,6219,2458,2341,4799,0.672737051,23586,21445,45031,3244,2944,6188,1,1,32939,741,33998,66937
Optimum Performing/Ideal role models,Above average state,HIMACHAL PRADESH,15-59,0,HIMACHAL PRADESH,AP,2,B0101,Total,Acceptable Performance,0.427126321,560973,1308151,1869124,270499,299278,569777,528679,344385,873064,211619,123074,334693,0.296880859,873837,425327,1299164,176467,112458,288925,1,1,2175108,696,2200937,4376045
Optimum Performing/Ideal role models,Above average state,SIKKIM,15-59,0,SIKKIM,AP,11,B0101,Total,Acceptable Performance,0.52573303,64683,147036,211719,8732,8380,17112,27153,19759,46912,9976,7064,17040,0.315463656,85277,41764,127041,15282,9461,24743,1,1,187089,741,215623,402712
Optimum Performing/Ideal role models,Above average state,HIMACHAL PRADESH,20-24,0,HIMACHAL PRADESH,AP,2,B0101,Total,Acceptable Performance,0.307963148,62529,135758,198287,54151,61531,115682,72727,57418,130145,33499,25446,58945,0.398357733,151391,105098,256489,49243,43772,93015,1,1,320146,696,323720,643866
Optimum Performing/Ideal role models,Above average state,SIKKIM,20-24,0,SIKKIM,AP,11,B0101,Total,Acceptable Performance,0.408963252,8601,18921,27522,2238,2224,4462,4579,4063,8642,1878,1672,3550,0.409869682,17093,10490,27583,4955,3571,8526,1,1,32151,741,35146,67297
Optimum Performing/Ideal role models,Above average state,HIMACHAL PRADESH,25-29,0,HIMACHAL PRADESH,AP,2,B0101,Total,Acceptable Performance,0.462522914,82639,189861,272500,51065,53965,105030,80305,55023,135328,27699,14608,42307,0.235971553,108392,30633,139025,36284,17110,53394,1,1,299035,696,290125,589160
Optimum Performing/Ideal role models,Above average state,SIKKIM,25-29,0,SIKKIM,AP,11,B0101,Total,Acceptable Performance,0.579650056,11351,26117,37468,1954,1782,3736,4753,3546,8299,1484,932,2416,0.254583146,12351,4105,16456,3541,1801,5342,1,1,29939,741,34700,64639
Optimum Performing/Ideal role models,Above average state,HIMACHAL PRADESH,30-34,0,HIMACHAL PRADESH,AP,2,B0101,Total,Acceptable Performance,0.519059882,84634,198958,283592,41751,44701,86452,75012,48907,123919,24743,10701,35444,0.189257207,90715,12687,103402,23588,6343,29931,1,1,275104,696,271253,546357
Optimum Performing/Ideal role models,Above average state,SIKKIM,30-34,0,SIKKIM,AP,11,B0101,Total,Acceptable Performance,0.652292963,10264,23802,34066,1160,1112,2272,3729,2516,6245,1082,621,1703,0.195519387,8588,1623,10211,1630,583,2213,1,1,23663,741,28562,52225
Optimum Performing/Ideal role models,Above average state,HIMACHAL PRADESH,35-39,0,HIMACHAL PRADESH,AP,2,B0101,Total,Acceptable Performance,0.544520297,85072,196971,282043,34783,37712,72495,71187,43590,114777,22996,9172,32168,0.171783476,80481,8497,88978,16752,3487,20239,1,1,259736,696,258230,517966
Optimum Performing/Ideal role models,Above average state,SIKKIM,35-39,0,SIKKIM,AP,11,B0101,Total,Acceptable Performance,0.671671213,9197,20106,29303,874,655,1529,3355,1889,5244,834,420,1254,0.179384326,6845,981,7826,981,249,1230,1,1,20231,741,23396,43627
Optimum Performing/Ideal role models,Above average state,HIMACHAL PRADESH,40-49,0,HIMACHAL PRADESH,AP,2,B0101,Total,Acceptable Performance,0.555655606,139798,327335,467133,43849,48289,92138,115609,63215,178824,36934,13442,50376,0.171710551,128436,15919,144355,16496,4477,20973,1,1,420777,696,419911,840688
Optimum Performing/Ideal role models,Above average state,SIKKIM,40-49,0,SIKKIM,AP,11,B0101,Total,Acceptable Performance,0.686248372,13734,31568,45302,948,770,1718,4768,2745,7513,1278,607,1885,0.171387887,9950,1364,11314,701,217,918,1,1,29730,741,36284,66014
Optimum Performing/Ideal role models,Above average state,HIMACHAL PRADESH,5-Sep,0,HIMACHAL PRADESH,AP,2,B0101,Total,Acceptable Performance,0.007483376,2008,2416,4424,822,986,1808,3835,3877,7712,9521,9954,19475,0.946528705,264356,295210,559566,1986,2355,4341,1,1,279720,696,311457,591177
Optimum Performing/Ideal role models,Above average state,SIKKIM,5-Sep,0,SIKKIM,AP,11,B0101,Total,Acceptable Performance,0.011380077,282,363,645,53,51,104,359,357,716,329,341,670,0.96416599,27020,27627,54647,335,323,658,1,1,27990,741,28688,56678
Optimum Performing/Ideal role models,Above average state,HIMACHAL PRADESH,50-59,0,HIMACHAL PRADESH,AP,2,B0101,Total,Acceptable Performance,0.512076874,86020,219970,305990,21931,25111,47042,79811,44003,123814,28784,11260,40044,0.213705365,101963,25736,127699,6178,3067,9245,1,1,296578,696,300969,597547
Optimum Performing/Ideal role models,Above average state,SIKKIM,50-59,0,SIKKIM,AP,11,B0101,Total,Acceptable Performance,0.647320897,7676,19494,27170,450,449,899,2934,1816,4750,962,471,1433,0.205370119,6864,1756,8620,230,96,326,1,1,18436,741,23537,41973
Optimum Performing/Ideal role models,Above average state,HIMACHAL PRADESH,60-69,0,HIMACHAL PRADESH,AP,2,B0101,Total,Acceptable Performance,0.303229148,37813,80440,118253,8576,11982,20558,43182,36599,79781,20869,12954,33823,0.405462858,94264,63858,158122,2414,2348,4762,1,1,196128,696,193851,389979
Optimum Performing/Ideal role models,Above average state,SIKKIM,60-69,0,SIKKIM,AP,11,B0101,Total,Acceptable Performance,0.457329505,2976,8015,10991,184,260,444,1471,1447,2918,648,476,1124,0.374485083,5904,3096,9000,169,102,271,1,1,10999,741,13034,24033
Optimum Performing/Ideal role models,Above average state,HIMACHAL PRADESH,60+,0,HIMACHAL PRADESH,AP,2,B0101,Total,Acceptable Performance,0.250518841,55329,120788,176117,11460,16331,27791,61923,56134,118057,33927,23816,57743,0.499413237,210955,140137,351092,3550,3189,6739,1,1,362134,696,340875,703009
Optimum Performing/Ideal role models,Above average state,SIKKIM,60+,0,SIKKIM,AP,11,B0101,Total,Acceptable Performance,0.382606989,3952,11640,15592,248,364,612,1990,2246,4236,893,822,1715,0.471363369,11445,7764,19209,225,149,374,1,1,18280,741,22472,40752
Optimum Performing/Ideal role models,Above average state,HIMACHAL PRADESH,70-79,0,HIMACHAL PRADESH,AP,2,B0101,Total,Acceptable Performance,0.213443985,13394,30638,44032,2219,3396,5615,14584,15033,29617,9770,7754,17524,0.558041233,69986,45134,115120,777,621,1398,1,1,107734,696,98559,206293
Optimum Performing/Ideal role models,Above average state,SIKKIM,70-79,0,SIKKIM,AP,11,B0101,Total,Acceptable Performance,0.302641384,746,2909,3655,51,85,136,428,672,1100,198,271,469,0.567442246,3845,3008,6853,37,30,67,1,1,5217,741,6860,12077
Optimum Performing/Ideal role models,Above average state,HIMACHAL PRADESH,80+,0,HIMACHAL PRADESH,AP,2,B0101,Total,Acceptable Performance,0.129589552,4122,9710,13832,665,953,1618,4157,4502,8659,3288,3108,6396,0.729362826,46705,31145,77850,359,220,579,1,1,58272,696,48465,106737
Optimum Performing/Ideal role models,Above average state,SIKKIM,80+,0,SIKKIM,AP,11,B0101,Total,Acceptable Performance,0.203791469,230,716,946,13,19,32,91,127,218,47,75,122,0.72296424,1696,1660,3356,19,17,36,1,1,2064,741,2578,4642
Optimum Performing/Ideal role models,Above average state,HIMACHAL PRADESH,Age not stated,0,HIMACHAL PRADESH,AP,2,B0101,Total,Acceptable Performance,0.222276887,672,1587,2259,316,357,673,647,520,1167,350,232,582,0.605628259,3141,3014,6155,239,150,389,1,1,4810,696,5353,10163
Optimum Performing/Ideal role models,Above average state,SIKKIM,Age not stated,0,SIKKIM,AP,11,B0101,Total,Acceptable Performance,0.324829932,119,263,382,19,12,31,43,44,87,37,28,65,0.545918367,340,302,642,29,12,41,1,1,539,741,637,1176
Optimum Performing/Ideal role models,Above average state,HIMACHAL PRADESH,Oct-14,0,HIMACHAL PRADESH,AP,2,B0101,Total,Acceptable Performance,0.016546625,4530,6047,10577,3749,3879,7628,12797,12263,25060,29239,30129,59368,0.851374479,254418,289801,544219,3747,4583,8330,1,1,300984,696,338240,639224
Optimum Performing/Ideal role models,Above average state,SIKKIM,Oct-14,0,SIKKIM,AP,11,B0101,Total,Acceptable Performance,0.030766702,848,1211,2059,221,305,526,1252,1262,2514,1864,1922,3786,0.875095259,28994,29570,58564,702,696,1398,1,1,32958,741,33965,66923
Optimum Performing/Ideal role models,Above average state,HIMACHAL PRADESH,Total,0,HIMACHAL PRADESH,AP,2,B0101,Total,Acceptable Performance,0.300454564,623512,1438989,2062501,286846,320831,607677,607881,417179,1025060,284656,187205,471861,0.481481665,1866680,1438500,3305180,185989,122735,308724,1,1,3382729,696,3481873,6864602
Optimum Performing/Ideal role models,Above average state,SIKKIM,Total,0,SIKKIM,AP,11,B0101,Total,Acceptable Performance,0.377343071,69884,160513,230397,9273,9112,18385,30797,23668,54465,13099,10177,23276,0.495333103,173727,128712,302439,16573,10641,27214,1,1,287507,741,323070,610577
Can be emulated,Above average state,KARNATAKA,15-19,0,KARNATAKA,AP,29,B0101,Urban,Acceptable Performance,0.167406097,99706,263400,363106,10861,19668,30529,30642,47819,78461,4324,10051,14375,0.789792869,926102,786969,1713071,80196,93820,174016,1,2,1060774,592,1108239,2169013
Can be emulated,Above average state,MAHARASHTRA,15-19,0,MAHARASHTRA,AP,27,B0101,Urban,Acceptable Performance,0.130656842,119281,487960,607241,15456,37948,53404,36831,70281,107112,5693,14448,20141,0.841962801,1984621,1928487,3913108,123524,198420,321944,1,2,2146426,596,2501176,4647602
Can be emulated,Above average state,KARNATAKA,15-59,0,KARNATAKA,AP,29,B0101,Urban,Acceptable Performance,0.49149027,1861897,5922666,7784563,87066,156866,243932,315691,462311,778002,49167,76169,125336,0.451476107,5518773,1632018,7150791,442749,300280,743029,1,2,7745528,592,8093164,15838692
Can be emulated,Above average state,MAHARASHTRA,15-59,0,MAHARASHTRA,AP,27,B0101,Urban,Acceptable Performance,0.475479323,3191790,12920474,16112264,148730,317935,466665,432957,697356,1130313,74790,116737,191527,0.485512652,12259681,4192576,16452257,754054,718181,1472235,1,2,15959218,596,17927143,33886361
Can be emulated,Above average state,KARNATAKA,20-24,0,KARNATAKA,AP,29,B0101,Urban,Acceptable Performance,0.384884862,248501,714917,963418,18902,36334,55236,49026,81180,130206,7482,15032,22514,0.554103597,938122,448873,1386995,134213,121264,255477,1,2,1243131,592,1260002,2503133
Can be emulated,Above average state,MAHARASHTRA,20-24,0,MAHARASHTRA,AP,27,B0101,Urban,Acceptable Performance,0.355719227,376218,1518386,1894604,30150,74573,104723,66342,130178,196520,12009,26045,38054,0.600238598,2044638,1152306,3196944,233425,287170,520595,1,2,2499207,596,2826915,5326122
Can be emulated,Above average state,KARNATAKA,25-29,0,KARNATAKA,AP,29,B0101,Urban,Acceptable Performance,0.535307291,337725,994172,1331897,17442,31971,49413,53655,81966,135621,8144,12765,20909,0.4017812,854807,144864,999671,101110,49997,151107,1,2,1254331,592,1233767,2488098
Can be emulated,Above average state,MAHARASHTRA,25-29,0,MAHARASHTRA,AP,27,B0101,Urban,Acceptable Performance,0.527422691,545065,2156307,2701372,27309,61885,89194,69853,124528,194381,12033,20272,32305,0.428318562,1811676,382101,2193777,168619,130018,298637,1,2,2438627,596,2683208,5121835
Can be emulated,Above average state,KARNATAKA,30-34,0,KARNATAKA,AP,29,B0101,Urban,Acceptable Performance,0.59817184,291194,929454,1220648,11769,21111,32880,44203,64178,108381,6844,9650,16494,0.340633853,641193,53915,695108,46369,14845,61214,1,2,983434,592,1057197,2040631
Can be emulated,Above average state,MAHARASHTRA,30-34,0,MAHARASHTRA,AP,27,B0101,Urban,Acceptable Performance,0.583533094,510902,2057289,2568191,21597,43082,64679,63354,97168,160522,11105,14601,25706,0.374152997,1498205,148482,1646687,88898,41516,130414,1,2,2083566,596,2317540,4401106
Can be emulated,Above average state,KARNATAKA,35-39,0,KARNATAKA,AP,29,B0101,Urban,Acceptable Performance,0.610265145,294398,880053,1174451,10592,17399,27991,45090,57772,102862,7292,8827,16119,0.32791026,596264,34797,631061,35792,7490,43282,1,2,943044,592,981449,1924493
Can be emulated,Above average state,MAHARASHTRA,35-39,0,MAHARASHTRA,AP,27,B0101,Urban,Acceptable Performance,0.598317065,504077,1903433,2407510,19749,35065,54814,61260,83367,144627,10948,12175,23123,0.359993519,1349359,99184,1448543,61680,21181,82861,1,2,1925644,596,2098159,4023803
Can be emulated,Above average state,KARNATAKA,40-49,0,KARNATAKA,AP,29,B0101,Urban,Acceptable Performance,0.605348854,391834,1339744,1731578,11910,21242,33152,60240,82698,142938,9567,13010,22577,0.336788135,903466,59904,963370,31298,7814,39112,1,2,1365107,592,1495356,2860463
Can be emulated,Above average state,MAHARASHTRA,40-49,0,MAHARASHTRA,AP,27,B0101,Urban,Acceptable Performance,0.59862896,749514,3020559,3770073,24027,45262,69289,87766,121448,209214,14987,17991,32978,0.362914717,2116629,168952,2285581,57119,23919,81038,1,2,2968896,596,3328950,6297846
Can be emulated,Above average state,KARNATAKA,5-Sep,0,KARNATAKA,AP,29,B0101,Urban,Acceptable Performance,0.010036803,8585,10805,19390,2069,2264,4333,11081,11784,22865,277,313,590,0.977822236,915894,973151,1889045,6027,6687,12714,1,2,935837,592,996053,1931890
Can be emulated,Above average state,MAHARASHTRA,5-Sep,0,MAHARASHTRA,AP,27,B0101,Urban,Acceptable Performance,0.011830339,21261,28072,49333,2818,3324,6142,14791,16710,31501,794,946,1740,0.980198276,1926885,2160582,4087467,10872,12779,23651,1,2,1963731,596,2206310,4170041
Can be emulated,Above average state,KARNATAKA,50-59,0,KARNATAKA,AP,29,B0101,Urban,Acceptable Performance,0.53941715,198539,800926,999465,5590,9141,14731,32835,46698,79533,5514,6834,12348,0.410994133,658819,102696,761515,13771,5050,18821,1,2,895707,592,957154,1852861
Can be emulated,Above average state,MAHARASHTRA,50-59,0,MAHARASHTRA,AP,27,B0101,Urban,Acceptable Performance,0.53177188,386733,1776540,2163273,10442,20120,30562,47551,70386,117937,8015,11205,19220,0.434512433,1454553,313064,1767617,20789,15957,36746,1,2,1896852,596,2171195,4068047
Can be emulated,Above average state,KARNATAKA,60-69,0,KARNATAKA,AP,29,B0101,Urban,Acceptable Performance,0.294638154,73656,276502,350158,2924,4312,7236,17671,24807,42478,3249,4256,7505,0.663303978,509679,278614,788293,8541,6258,14799,1,2,604255,592,584179,1188434
Can be emulated,Above average state,MAHARASHTRA,60-69,0,MAHARASHTRA,AP,27,B0101,Urban,Acceptable Performance,0.262492778,138967,532116,671083,6188,9554,15742,27165,37230,64395,5514,7205,12719,0.707344234,1118953,689427,1808380,12956,12331,25287,1,2,1290599,596,1265978,2556577
Can be emulated,Above average state,KARNATAKA,60+,0,KARNATAKA,AP,29,B0101,Urban,Acceptable Performance,0.248928833,98627,372835,471462,3972,6012,9984,24789,35620,60409,4372,6009,10381,0.713694513,851236,500475,1351711,11125,8047,19172,1,2,979024,592,914939,1893963
Can be emulated,Above average state,MAHARASHTRA,60+,0,MAHARASHTRA,AP,27,B0101,Urban,Acceptable Performance,0.220693697,189136,723961,913097,8337,13181,21518,38935,54427,93362,7702,10880,18582,0.752249664,1887005,1225349,3112354,18304,17116,35420,1,2,2122778,596,2014617,4137395
Can be emulated,Above average state,KARNATAKA,70-79,0,KARNATAKA,AP,29,B0101,Urban,Acceptable Performance,0.177870997,17361,71429,88790,704,1169,1873,4985,8004,12989,823,1339,2162,0.791777348,234360,160881,395241,1927,1388,3315,1,2,257529,592,241653,499182
Can be emulated,Above average state,MAHARASHTRA,70-79,0,MAHARASHTRA,AP,27,B0101,Urban,Acceptable Performance,0.15586766,35768,140357,176125,1544,2609,4153,8503,12753,21256,1644,2796,4440,0.821391813,538272,389872,928144,3714,3369,7083,1,2,584187,596,545778,1129965
Can be emulated,Above average state,KARNATAKA,80+,0,KARNATAKA,AP,29,B0101,Urban,Acceptable Performance,0.157569531,7610,24904,32514,344,531,875,2133,2809,4942,300,414,714,0.81502033,107197,60980,168177,657,401,1058,1,2,117240,592,89107,206347
Can be emulated,Above average state,MAHARASHTRA,80+,0,MAHARASHTRA,AP,27,B0101,Urban,Acceptable Performance,0.146142978,14401,51488,65889,605,1018,1623,3267,4444,7711,544,879,1423,0.833597647,229780,146050,375830,1634,1416,3050,1,2,247992,596,202861,450853
Can be emulated,Above average state,KARNATAKA,Age not stated,0,KARNATAKA,AP,29,B0101,Urban,Acceptable Performance,0.263460194,1419,3856,5275,92,150,242,463,647,1110,30,54,84,0.676905404,6653,6900,13553,85,92,177,1,2,8565,592,11457,20022
Can be emulated,Above average state,MAHARASHTRA,Age not stated,0,MAHARASHTRA,AP,27,B0101,Urban,Acceptable Performance,0.347579138,15109,55021,70130,780,1442,2222,3259,4781,8040,323,541,864,0.608290751,72487,50246,122733,1806,1995,3801,1,2,91178,596,110589,201767
Can be emulated,Above average state,KARNATAKA,Oct-14,0,KARNATAKA,AP,29,B0101,Urban,Acceptable Performance,0.02679914,18932,36654,55586,3227,4130,7357,15353,17360,32713,994,1607,2601,0.956175262,973330,1009941,1983271,10220,12137,22357,1,2,1008609,592,1065562,2074171
Can be emulated,Above average state,MAHARASHTRA,Oct-14,0,MAHARASHTRA,AP,27,B0101,Urban,Acceptable Performance,0.024115336,34911,73089,108000,4590,6903,11493,19764,24204,43968,1681,2605,4286,0.965110022,2048017,2274207,4322224,19168,28009,47177,1,2,2104373,596,2374105,4478478
Can be emulated,Above average state,KARNATAKA,Total,0,KARNATAKA,AP,29,B0101,Urban,Acceptable Performance,0.352843876,1989460,6346816,8336276,96426,169422,265848,367377,527722,895099,54840,84152,138992,0.603386859,9176982,5078613,14255595,470206,327243,797449,1,2,11588659,592,12037303,23625962
Can be emulated,Above average state,MAHARASHTRA,Total,0,MAHARASHTRA,AP,27,B0101,Urban,Acceptable Performance,0.339500493,3452207,13800617,17252824,165255,342785,508040,509706,797478,1307184,85290,131709,216999,0.630506685,20067034,11974218,32041252,804204,778080,1582284,1,2,24114237,596,26704022,50818259
Not considered,Above average state,ANDAMAN & NICOBAR ISLANDS,15-19,0,ANDAMAN & NICOBAR ISLANDS,AP,35,B0101,Urban,Acceptable Performance,0.101682863,222,1065,1287,97,152,249,125,183,308,5,35,40,0.87082247,5683,5339,11022,1723,1630,3353,1,2,6035,593,6622,12657
Not considered,Above average state,ANDHRA PRADESH,15-19,0,ANDHRA PRADESH,AP,28,B0101,Urban,Acceptable Performance,0.117536539,98750,225613,324363,22007,31207,53214,48779,60337,109116,5237,7851,13088,0.838181483,1210598,1102513,2313111,142990,157525,300515,1,1,1363364,635,1396314,2759678
Not considered,Above average state,CHHATTISGARH,15-19,0,CHHATTISGARH,AP,22,B0101,Urban,Acceptable Performance,0.121706705,17645,55597,73242,4576,8426,13002,7332,11134,18466,2785,4055,6840,0.836242151,263912,239331,503243,25962,34342,60304,1,1,291674,660,310117,601791
Not considered,Above average state,DAMAN & DIU,15-19,0,DAMAN & DIU,AP,25,B0101,Urban,Acceptable Performance,0.540515794,650,9976,10626,30,114,144,60,259,319,18,208,226,0.431761534,4458,4030,8488,372,493,865,1,2,5186,588,14473,19659
Not considered,Above average state,GUJARAT,15-19,0,GUJARAT,AP,24,B0101,Urban,Acceptable Performance,0.18551406,68541,387680,456221,8731,19629,28360,25887,42170,68057,4475,7359,11834,0.781999702,995787,927327,1923114,55648,88725,144373,1,1,1094690,603,1364536,2459226
Not considered,Above average state,MEGHALAYA,15-19,0,MEGHALAYA,AP,17,B0101,Urban,Acceptable Performance,0.095189852,2120,4739,6859,563,769,1332,850,1185,2035,245,301,546,0.868990785,33263,29353,62616,5284,4900,10184,1,1,36478,660,35578,72056
Not considered,Above average state,MIZORAM,15-19,0,MIZORAM,AP,15,B0101,Urban,Acceptable Performance,0.108444563,2349,4167,6516,699,925,1624,1155,1369,2524,666,820,1486,0.824817761,26009,23551,49560,4628,4309,8937,1,1,30179,657,29907,60086
Not considered,Above average state,RAJASTHAN,15-19,0,RAJASTHAN,AP,8,B0101,Urban,Acceptable Performance,0.114038882,34875,172343,207218,9549,23742,33291,19761,33739,53500,5131,7378,12509,0.849634194,785524,758331,1543855,67809,103224,171033,1,2,845291,569,971791,1817082
Not considered,Above average state,TAMIL NADU,15-19,0,TAMIL NADU,AP,33,B0101,Urban,Acceptable Performance,0.125310429,118697,242284,360981,19449,27147,46596,37088,47586,84674,4406,7320,11726,0.841225413,1255898,1167415,2423313,161434,196010,357444,1,1,1416089,610,1464605,2880694
Not considered,Above average state,TRIPURA,15-19,0,TRIPURA,AP,16,B0101,Urban,Acceptable Performance,0.074571081,931,5254,6185,829,1822,2651,830,1820,2650,220,498,718,0.884821741,39201,34187,73388,15727,13388,29115,1,2,41182,582,41759,82941
Not considered,Above average state,ANDAMAN & NICOBAR ISLANDS,15-59,0,ANDAMAN & NICOBAR ISLANDS,AP,35,B0101,Urban,Acceptable Performance,0.505786562,9997,41748,51745,899,1933,2832,1198,2365,3563,180,407,587,0.453648857,35845,10566,46411,10742,4743,15485,1,2,47220,593,55086,102306
Not considered,Above average state,ANDHRA PRADESH,15-59,0,ANDHRA PRADESH,AP,28,B0101,Urban,Acceptable Performance,0.436809809,1841594,6301663,8143257,188457,282357,470814,488920,596919,1085839,67058,85088,152146,0.496783839,6886225,2375102,9261327,774508,553729,1328237,1,1,9283797,635,9358772,18642569
Not considered,Above average state,CHHATTISGARH,15-59,0,CHHATTISGARH,AP,22,B0101,Urban,Acceptable Performance,0.455856868,365915,1394906,1760821,43405,69539,112944,80934,94405,175339,19557,20049,39606,0.488496275,1414931,471965,1886896,151693,123960,275653,1,1,1881337,660,1981325,3862662
Not considered,Above average state,DAMAN & DIU,15-59,0,DAMAN & DIU,AP,25,B0101,Urban,Acceptable Performance,0.674282046,8087,84351,92438,246,548,794,652,1278,1930,153,706,859,0.305373803,34078,7786,41864,3098,1620,4718,1,2,42970,588,94121,137091
Not considered,Above average state,GUJARAT,15-59,0,GUJARAT,AP,24,B0101,Urban,Acceptable Performance,0.464009514,974466,6946865,7921331,59298,113890,173188,234528,310107,544635,31878,41021,72899,0.499817063,6744959,1787660,8532619,305334,241157,546491,1,1,7985831,603,9085653,17071484
Not considered,Above average state,MEGHALAYA,15-59,0,MEGHALAYA,AP,17,B0101,Urban,Acceptable Performance,0.466764669,57127,122906,180033,3798,4910,8708,7212,8912,16124,1304,1517,2821,0.484117354,127206,59520,186726,24896,16220,41116,1,1,192849,660,192855,385704
Not considered,Above average state,MIZORAM,15-59,0,MIZORAM,AP,15,B0101,Urban,Acceptable Performance,0.494467191,64098,119468,183566,5797,7249,13046,14265,11692,25957,3489,3662,7151,0.416350609,103962,50604,154566,21306,14741,36047,1,1,185814,657,185426,371240
Not considered,Above average state,RAJASTHAN,15-59,0,RAJASTHAN,AP,8,B0101,Urban,Acceptable Performance,0.424263629,657814,3887615,4545429,80856,171678,252534,196796,267837,464633,41089,38994,80083,0.524893384,4235895,1387650,5623545,371430,313197,684627,1,2,5131594,569,5582096,10713690
Not considered,Above average state,TAMIL NADU,15-59,0,TAMIL NADU,AP,33,B0101,Urban,Acceptable Performance,0.492169504,2939865,8613286,11553151,173048,264836,437884,441161,591875,1033036,80639,102856,183495,0.456005721,8319964,2384281,10704245,1095022,621300,1716322,1,1,11781629,610,11692298,23473927
Not considered,Above average state,TRIPURA,15-59,0,TRIPURA,AP,16,B0101,Urban,Acceptable Performance,0.424942689,47098,236145,283243,17534,18927,36461,16730,20040,36770,7711,4140,11851,0.502112389,256388,78292,334680,126922,43452,170374,1,2,327927,582,338617,666544
Not considered,Above average state,ANDAMAN & NICOBAR ISLANDS,20-24,0,ANDAMAN & NICOBAR ISLANDS,AP,35,B0101,Urban,Acceptable Performance,0.353756432,751,4405,5156,190,460,650,204,506,710,32,87,119,0.589365352,5714,2876,8590,2870,1867,4737,1,2,6701,593,7874,14575
Not considered,Above average state,ANDHRA PRADESH,20-24,0,ANDHRA PRADESH,AP,28,B0101,Urban,Acceptable Performance,0.283299702,210856,601879,812735,36729,56444,93173,74819,95823,170642,8953,13042,21995,0.649551714,1201162,662283,1863445,217773,213971,431744,1,1,1495790,635,1373027,2868817
Not considered,Above average state,CHHATTISGARH,20-24,0,CHHATTISGARH,AP,22,B0101,Urban,Acceptable Performance,0.311189016,38295,153263,191558,7399,14906,22305,11793,17872,29665,3197,4532,7729,0.628063837,254067,132549,386616,47491,49178,96669,1,1,307352,660,308216,615568
Not considered,Above average state,DAMAN & DIU,20-24,0,DAMAN & DIU,AP,25,B0101,Urban,Acceptable Performance,0.716413181,1156,21454,22610,47,164,211,94,337,431,31,254,285,0.260899873,6471,1763,8234,829,561,1390,1,2,7752,588,23808,31560
Not considered,Above average state,GUJARAT,20-24,0,GUJARAT,AP,24,B0101,Urban,Acceptable Performance,0.397178241,121077,932084,1053161,11321,28069,39390,35061,62821,97882,5072,9340,14412,0.560472362,1058032,428121,1486153,80392,87398,167790,1,1,1219242,603,1432366,2651608
Not considered,Above average state,MEGHALAYA,20-24,0,MEGHALAYA,AP,17,B0101,Urban,Acceptable Performance,0.280678057,5113,13796,18909,1031,1353,2384,1341,1870,3211,249,348,597,0.662797429,26898,17754,44652,8544,6770,15314,1,1,33601,660,33768,67369
Not considered,Above average state,MIZORAM,20-24,0,MIZORAM,AP,15,B0101,Urban,Acceptable Performance,0.318905481,6266,13104,19370,1297,1928,3225,2287,2642,4929,685,913,1598,0.573634732,21303,13539,34842,6578,5347,11925,1,1,30541,657,30198,60739
Not considered,Above average state,RAJASTHAN,20-24,0,RAJASTHAN,AP,8,B0101,Urban,Acceptable Performance,0.310095066,70147,470576,540723,13913,38582,52495,28717,53358,82075,6060,8574,14634,0.634444035,733000,373301,1106301,111052,125125,236177,1,2,837924,569,905809,1743733
Not considered,Above average state,TAMIL NADU,20-24,0,TAMIL NADU,AP,33,B0101,Urban,Acceptable Performance,0.349979605,310857,772788,1083645,38892,58953,97845,63821,87652,151473,9799,15714,25513,0.59286008,1215798,619880,1835678,291360,246658,538018,1,1,1600275,610,1496034,3096309
Not considered,Above average state,TRIPURA,20-24,0,TRIPURA,AP,16,B0101,Urban,Acceptable Performance,0.238621467,2844,19181,22025,2280,4158,6438,2063,3976,6039,720,988,1708,0.677446615,41361,21168,62529,26623,15136,41759,1,2,46988,582,45313,92301
Not considered,Above average state,ANDAMAN & NICOBAR ISLANDS,25-29,0,ANDAMAN & NICOBAR ISLANDS,AP,35,B0101,Urban,Acceptable Performance,0.511012126,1421,6839,8260,219,512,731,240,554,794,43,80,123,0.432256867,5905,1082,6987,2541,776,3317,1,2,7609,593,8555,16164
Not considered,Above average state,ANDHRA PRADESH,25-29,0,ANDHRA PRADESH,AP,28,B0101,Urban,Acceptable Performance,0.462195041,306831,988912,1295743,36577,54734,91311,82994,102950,185944,11238,14358,25596,0.462348067,1045647,250525,1296172,169660,107716,277376,1,1,1446710,635,1356745,2803455
Not considered,Above average state,CHHATTISGARH,25-29,0,CHHATTISGARH,AP,22,B0101,Urban,Acceptable Performance,0.485815435,52384,214386,266770,6897,12887,19784,11676,16536,28212,2859,3267,6126,0.451651558,203488,44522,248010,31974,23553,55527,1,1,270407,660,278711,549118
Not considered,Above average state,DAMAN & DIU,25-29,0,DAMAN & DIU,AP,25,B0101,Urban,Acceptable Performance,0.705906268,1409,17690,19099,44,94,138,92,223,315,26,103,129,0.277683323,6901,612,7513,740,268,1008,1,2,8428,588,18628,27056
Not considered,Above average state,GUJARAT,25-29,0,GUJARAT,AP,24,B0101,Urban,Acceptable Performance,0.510980651,143113,1140103,1283216,9274,20370,29644,34722,54430,89152,4506,6607,11113,0.44909351,1001060,126740,1127800,58772,32472,91244,1,1,1183401,603,1327880,2511281
Not considered,Above average state,MEGHALAYA,25-29,0,MEGHALAYA,AP,17,B0101,Urban,Acceptable Performance,0.523851189,9558,21575,31133,895,1182,2077,1353,1737,3090,227,278,505,0.415658495,18581,6122,24703,5705,3005,8710,1,1,29719,660,29712,59431
Not considered,Above average state,MIZORAM,25-29,0,MIZORAM,AP,15,B0101,Urban,Acceptable Performance,0.515921518,9498,19374,28872,1252,1605,2857,2507,2409,4916,584,631,1215,0.374521997,15425,5534,20959,4267,2711,6978,1,1,28014,657,27948,55962
Not considered,Above average state,RAJASTHAN,25-29,0,RAJASTHAN,AP,8,B0101,Urban,Acceptable Performance,0.470971181,93490,620410,713900,12895,30952,43847,28923,46215,75138,6020,6317,12337,0.471320171,606165,108264,714429,76206,49875,126081,1,2,734598,569,781206,1515804
Not considered,Above average state,TAMIL NADU,25-29,0,TAMIL NADU,AP,33,B0101,Urban,Acceptable Performance,0.510208437,419336,1266009,1685345,35742,53440,89182,68402,94387,162789,11303,15581,26884,0.432371411,1219331,208899,1428230,258465,103418,361883,1,1,1718372,610,1584876,3303248
Not considered,Above average state,TRIPURA,25-29,0,TRIPURA,AP,16,B0101,Urban,Acceptable Performance,0.408263865,5236,32034,37270,3080,3966,7046,2705,4001,6706,1149,761,1910,0.497354555,36529,8874,45403,24061,7338,31399,1,2,45619,582,45670,91289
Not considered,Above average state,ANDAMAN & NICOBAR ISLANDS,30-34,0,ANDAMAN & NICOBAR ISLANDS,AP,35,B0101,Urban,Acceptable Performance,0.579859114,1518,6549,8067,164,321,485,210,399,609,37,58,95,0.36953709,4733,408,5141,1557,255,1812,1,2,6498,593,7414,13912
Not considered,Above average state,ANDHRA PRADESH,30-34,0,ANDHRA PRADESH,AP,28,B0101,Urban,Acceptable Performance,0.553662828,291588,1009936,1301524,26623,39433,66056,70054,84023,154077,9887,12065,21952,0.371455177,785731,87468,873199,84596,31480,116076,1,1,1157260,635,1193492,2350752
Not considered,Above average state,CHHATTISGARH,30-34,0,CHHATTISGARH,AP,22,B0101,Urban,Acceptable Performance,0.558520346,55030,210299,265329,6318,9583,15901,11718,12797,24515,2546,2307,4853,0.379659704,164196,16164,180360,18626,8170,26796,1,1,233490,660,241567,475057
Not considered,Above average state,DAMAN & DIU,30-34,0,DAMAN & DIU,AP,25,B0101,Urban,Acceptable Performance,0.705444761,1370,12001,13371,42,57,99,90,151,241,27,40,67,0.278305371,4976,299,5275,468,137,605,1,2,6463,588,12491,18954
Not considered,Above average state,GUJARAT,30-34,0,GUJARAT,AP,24,B0101,Urban,Acceptable Performance,0.545241828,143273,1057711,1200984,8118,13728,21846,33773,40413,74186,4395,4798,9193,0.416904447,863666,54634,918300,36526,11324,47850,1,1,1045107,603,1157556,2202663
Not considered,Above average state,MEGHALAYA,30-34,0,MEGHALAYA,AP,17,B0101,Urban,Acceptable Performance,0.62759356,9097,20334,29431,509,631,1140,964,1231,2195,171,181,352,0.318093613,12911,2006,14917,2523,797,3320,1,1,23143,660,23752,46895
Not considered,Above average state,MIZORAM,30-34,0,MIZORAM,AP,15,B0101,Urban,Acceptable Performance,0.599065157,10174,19560,29734,886,1089,1975,2249,1789,4038,446,444,890,0.301648064,12225,2747,14972,2568,1195,3763,1,1,25094,657,24540,49634
Not considered,Above average state,RAJASTHAN,30-34,0,RAJASTHAN,AP,8,B0101,Urban,Acceptable Performance,0.527663898,100681,590488,691169,12048,23070,35118,29195,35900,65095,5821,4435,10256,0.41481037,505711,37635,543346,43584,15241,58825,1,2,641408,569,668458,1309866
Not considered,Above average state,TAMIL NADU,30-34,0,TAMIL NADU,AP,33,B0101,Urban,Acceptable Performance,0.581365275,422402,1316079,1738481,24250,36200,60450,59879,80121,140000,11248,13204,24452,0.363640346,1007576,79833,1087409,143482,32188,175670,1,1,1501105,610,1489237,2990342
Not considered,Above average state,TRIPURA,30-34,0,TRIPURA,AP,16,B0101,Urban,Acceptable Performance,0.489387611,5975,34214,40189,2972,2752,5724,2632,2872,5504,1271,498,1769,0.422047954,30743,3916,34659,19240,3207,22447,1,2,40621,582,41500,82121
Not considered,Above average state,ANDAMAN & NICOBAR ISLANDS,35-39,0,ANDAMAN & NICOBAR ISLANDS,AP,35,B0101,Urban,Acceptable Performance,0.608128834,1685,6245,7930,109,199,308,172,251,423,19,56,75,0.353680982,4418,194,4612,1109,103,1212,1,2,6294,593,6746,13040
Not considered,Above average state,ANDHRA PRADESH,35-39,0,ANDHRA PRADESH,AP,28,B0101,Urban,Acceptable Performance,0.572164914,301414,992240,1293654,24642,34828,59470,68554,77335,145889,10218,11359,21577,0.353767236,746727,53134,799861,66757,15039,81796,1,1,1126913,635,1134068,2260981
Not considered,Above average state,CHHATTISGARH,35-39,0,CHHATTISGARH,AP,22,B0101,Urban,Acceptable Performance,0.589398175,59734,205494,265228,6154,8218,14372,11686,11358,23044,2535,1799,4334,0.349761554,148120,9272,157392,12512,3713,16225,1,1,222075,660,227923,449998
Not considered,Above average state,DAMAN & DIU,35-39,0,DAMAN & DIU,AP,25,B0101,Urban,Acceptable Performance,0.713834152,1319,9295,10614,36,48,84,113,106,219,18,38,56,0.267670993,3765,215,3980,315,66,381,1,2,5215,588,9654,14869
Not considered,Above average state,GUJARAT,35-39,0,GUJARAT,AP,24,B0101,Urban,Acceptable Performance,0.559458597,142919,954374,1097293,7519,10816,18335,31809,32523,64332,4135,3700,7835,0.403746811,754966,36922,791888,28367,6358,34725,1,1,933829,603,1027519,1961348
Not considered,Above average state,MEGHALAYA,35-39,0,MEGHALAYA,AP,17,B0101,Urban,Acceptable Performance,0.652381638,8936,18237,27173,382,424,806,908,988,1896,125,131,256,0.295952175,11253,1074,12327,1574,372,1946,1,1,21222,660,20430,41652
Not considered,Above average state,MIZORAM,35-39,0,MIZORAM,AP,15,B0101,Urban,Acceptable Performance,0.658422279,9553,17281,26834,694,670,1364,1802,1160,2962,365,288,653,0.252876948,8679,1627,10306,1634,591,2225,1,1,20399,657,20356,40755
Not considered,Above average state,RAJASTHAN,35-39,0,RAJASTHAN,AP,8,B0101,Urban,Acceptable Performance,0.55205291,105368,559397,664765,11581,19030,30611,28682,30590,59272,5774,3698,9472,0.390858758,448389,22271,470660,30506,6897,37403,1,2,588213,569,615956,1204169
Not considered,Above average state,TAMIL NADU,35-39,0,TAMIL NADU,AP,33,B0101,Urban,Acceptable Performance,0.60828786,485284,1304190,1789474,21763,31405,53168,62195,75016,137211,12608,12921,25529,0.336392663,941904,47703,989607,112793,15420,128213,1,1,1501991,610,1439830,2941821
Not considered,Above average state,TRIPURA,35-39,0,TRIPURA,AP,16,B0101,Urban,Acceptable Performance,0.531467439,7721,36504,44225,3165,2223,5388,2874,2401,5275,1409,401,1810,0.383389615,29816,2087,31903,17038,1549,18587,1,2,41820,582,41393,83213
Not considered,Above average state,ANDAMAN & NICOBAR ISLANDS,40-49,0,ANDAMAN & NICOBAR ISLANDS,AP,35,B0101,Urban,Acceptable Performance,0.665379856,2943,10501,13444,96,197,293,183,311,494,33,57,90,0.305716407,5875,302,6177,767,79,846,1,2,9034,593,11171,20205
Not considered,Above average state,ANDHRA PRADESH,40-49,0,ANDHRA PRADESH,AP,28,B0101,Urban,Acceptable Performance,0.580868547,417385,1585764,2003149,28263,45455,73718,92145,113418,205563,13590,16856,30446,0.350694105,1125805,83578,1209383,64769,16173,80942,1,1,1648925,635,1799616,3448541
Not considered,Above average state,CHHATTISGARH,40-49,0,CHHATTISGARH,AP,22,B0101,Urban,Acceptable Performance,0.60804797,95376,350598,445974,8555,10889,19444,17686,16248,33934,3627,2613,6240,0.337178166,234045,13259,247304,11422,3355,14777,1,1,350734,660,382718,733452
Not considered,Above average state,DAMAN & DIU,40-49,0,DAMAN & DIU,AP,25,B0101,Urban,Acceptable Performance,0.688457911,1568,10111,11679,32,51,83,135,134,269,22,43,65,0.291853336,4607,344,4951,317,65,382,1,2,6332,588,10632,16964
Not considered,Above average state,GUJARAT,40-49,0,GUJARAT,AP,24,B0101,Urban,Acceptable Performance,0.556412076,232137,1548252,1780389,10045,14224,24269,48248,47971,96219,6124,5463,11587,0.409896096,1242695,68877,1311572,32554,8081,40635,1,1,1529204,603,1670563,3199767
Not considered,Above average state,MEGHALAYA,40-49,0,MEGHALAYA,AP,17,B0101,Urban,Acceptable Performance,0.687620137,14413,28872,43285,307,408,715,1182,1303,2485,199,189,388,0.266739742,15263,1528,16791,992,274,1266,1,1,31057,660,31892,62949
Not considered,Above average state,MIZORAM,40-49,0,MIZORAM,AP,15,B0101,Urban,Acceptable Performance,0.704057204,16328,28374,44702,675,704,1379,2699,1430,4129,456,358,814,0.218090468,11919,1928,13847,1175,416,1591,1,1,31402,657,32090,63492
Not considered,Above average state,RAJASTHAN,40-49,0,RAJASTHAN,AP,8,B0101,Urban,Acceptable Performance,0.562470456,163724,910756,1074480,14624,24757,39381,40874,43533,84407,7981,5324,13305,0.386379115,702942,35153,738095,30866,7704,38570,1,2,915521,569,994766,1910287
Not considered,Above average state,TAMIL NADU,40-49,0,TAMIL NADU,AP,33,B0101,Urban,Acceptable Performance,0.617156901,762554,2260320,3022874,23213,40136,63349,93546,125422,218968,19030,22592,41622,0.329640446,1530120,84480,1614600,95896,16510,112406,1,1,2405250,610,2492814,4898064
Not considered,Above average state,TRIPURA,40-49,0,TRIPURA,AP,16,B0101,Urban,Acceptable Performance,0.574594656,14979,65963,80942,3791,2713,6504,3895,3134,7029,2025,545,2570,0.357263537,47415,2912,50327,18676,1628,20304,1,2,68314,582,72554,140868
Not considered,Above average state,ANDAMAN & NICOBAR ISLANDS,5-Sep,0,ANDAMAN & NICOBAR ISLANDS,AP,35,B0101,Urban,Acceptable Performance,0.010724819,54,66,120,14,16,30,39,51,90,0,0,0,0.981231567,5433,5546,10979,150,159,309,1,2,5526,593,5663,11189
Not considered,Above average state,ANDHRA PRADESH,5-Sep,0,ANDHRA PRADESH,AP,28,B0101,Urban,Acceptable Performance,0.012026742,11384,16609,27993,4785,5454,10239,20699,22418,43117,435,535,970,0.969031988,1093739,1161744,2255483,8479,9379,17858,1,1,1126257,635,1201306,2327563
Not considered,Above average state,CHHATTISGARH,5-Sep,0,CHHATTISGARH,AP,22,B0101,Urban,Acceptable Performance,0.004073718,981,1269,2250,144,146,290,778,789,1567,135,150,285,0.992573159,264144,284075,548219,1352,1503,2855,1,1,266038,660,286283,552321
Not considered,Above average state,DAMAN & DIU,5-Sep,0,DAMAN & DIU,AP,25,B0101,Urban,Acceptable Performance,0.005651935,30,42,72,2,4,6,6,12,18,1,0,1,0.992856582,5856,6792,12648,72,62,134,1,2,5893,588,6846,12739
Not considered,Above average state,GUJARAT,5-Sep,0,GUJARAT,AP,24,B0101,Urban,Acceptable Performance,0.009576145,7042,14286,21328,1251,1695,2946,6276,7902,14178,454,606,1060,0.983582084,989084,1201551,2190635,6174,8157,14331,1,1,1002856,603,1224345,2227201
Not considered,Above average state,MEGHALAYA,5-Sep,0,MEGHALAYA,AP,17,B0101,Urban,Acceptable Performance,0.004458066,114,142,256,98,103,201,202,228,430,14,16,30,0.987531346,27856,28852,56708,369,345,714,1,1,28186,660,29238,57424
Not considered,Above average state,MIZORAM,5-Sep,0,MIZORAM,AP,15,B0101,Urban,Acceptable Performance,0.003686758,96,99,195,24,24,48,63,66,129,70,61,131,0.991397565,25848,26589,52437,515,487,1002,1,1,26077,657,26815,52892
Not considered,Above average state,RAJASTHAN,5-Sep,0,RAJASTHAN,AP,8,B0101,Urban,Acceptable Performance,0.005347949,3712,5467,9179,865,1103,1968,3301,3915,7216,332,350,682,0.99005045,787122,912160,1699282,5419,6836,12255,1,2,794467,569,921892,1716359
Not considered,Above average state,TAMIL NADU,5-Sep,0,TAMIL NADU,AP,33,B0101,Urban,Acceptable Performance,0.006172952,6928,9015,15943,3351,3535,6886,13420,13713,27133,275,280,555,0.983106563,1239757,1299331,2539088,8250,8965,17215,1,1,1260380,610,1322339,2582719
Not considered,Above average state,TRIPURA,5-Sep,0,TRIPURA,AP,16,B0101,Urban,Acceptable Performance,0.003155459,87,138,225,40,39,79,131,144,275,6,10,16,0.992763481,34589,36200,70789,438,469,907,1,2,34813,582,36492,71305
Not considered,Above average state,ANDAMAN & NICOBAR ISLANDS,50-59,0,ANDAMAN & NICOBAR ISLANDS,AP,35,B0101,Urban,Acceptable Performance,0.646728495,1457,6144,7601,24,92,116,64,161,225,11,34,45,0.330298647,3517,365,3882,175,33,208,1,2,5049,593,6704,11753
Not considered,Above average state,ANDHRA PRADESH,50-59,0,ANDHRA PRADESH,AP,28,B0101,Urban,Acceptable Performance,0.51716771,214770,897319,1112089,13616,20256,33872,51575,63033,114608,7935,9557,17492,0.421400287,770555,135601,906156,27963,11825,39788,1,1,1044835,635,1105510,2150345
Not considered,Above average state,CHHATTISGARH,50-59,0,CHHATTISGARH,AP,22,B0101,Urban,Acceptable Performance,0.577410791,47451,205269,252720,3506,4630,8136,9043,8460,17503,2008,1476,3484,0.374638433,147103,16868,163971,3706,1649,5355,1,1,205605,660,232073,437678
Not considered,Above average state,DAMAN & DIU,50-59,0,DAMAN & DIU,AP,25,B0101,Urban,Acceptable Performance,0.552870843,615,3824,4439,15,20,35,68,68,136,11,20,31,0.426329555,2900,523,3423,57,30,87,1,2,3594,588,4435,8029
Not considered,Above average state,GUJARAT,50-59,0,GUJARAT,AP,24,B0101,Urban,Acceptable Performance,0.503486542,123406,926661,1050067,4290,7054,11344,25028,29779,54807,3171,3754,6925,0.466914174,828753,145039,973792,13075,6799,19874,1,1,980358,603,1105233,2085591
Not considered,Above average state,MEGHALAYA,50-59,0,MEGHALAYA,AP,17,B0101,Urban,Acceptable Performance,0.65747341,7890,15353,23243,111,143,254,614,598,1212,88,89,177,0.303236026,9037,1683,10720,274,102,376,1,1,17629,660,17723,35352
Not considered,Above average state,MIZORAM,50-59,0,MIZORAM,AP,15,B0101,Urban,Acceptable Performance,0.678743961,9930,17608,27538,294,328,622,1566,893,2459,287,208,495,0.248447205,8402,1678,10080,456,172,628,1,1,20185,657,20387,40572
Not considered,Above average state,RAJASTHAN,50-59,0,RAJASTHAN,AP,8,B0101,Urban,Acceptable Performance,0.538589601,89529,563645,653174,6246,11545,17791,20644,24502,45146,4302,3268,7570,0.417942212,454164,52695,506859,11407,5131,16538,1,2,568639,569,644110,1212749
Not considered,Above average state,TAMIL NADU,50-59,0,TAMIL NADU,AP,33,B0101,Urban,Acceptable Performance,0.5566759,420735,1451616,1872351,9739,17555,27294,56230,81691,137921,12245,15524,27769,0.394062167,1149337,176071,1325408,31592,11096,42688,1,1,1638547,610,1724902,3363449
Not considered,Above average state,TRIPURA,50-59,0,TRIPURA,AP,16,B0101,Urban,Acceptable Performance,0.558644509,9412,42995,52407,1417,1293,2710,1731,1836,3567,917,449,1366,0.38877104,31323,5148,36471,5557,1206,6763,1,2,43383,582,50428,93811
Not considered,Above average state,ANDAMAN & NICOBAR ISLANDS,60-69,0,ANDAMAN & NICOBAR ISLANDS,AP,35,B0101,Urban,Acceptable Performance,0.215265355,128,955,1083,3,20,23,24,61,85,2,22,24,0.763068972,2016,1823,3839,41,51,92,1,2,2170,593,2861,5031
Not considered,Above average state,ANDHRA PRADESH,60-69,0,ANDHRA PRADESH,AP,28,B0101,Urban,Acceptable Performance,0.299882108,92553,327413,419966,6971,10535,17506,28119,36779,64898,5034,6395,11429,0.645615619,595649,308495,904144,18236,13336,31572,1,1,721355,635,679082,1400437
Not considered,Above average state,CHHATTISGARH,60-69,0,CHHATTISGARH,AP,22,B0101,Urban,Acceptable Performance,0.298442437,17896,59648,77544,1530,2246,3776,4768,5268,10036,1425,1109,2534,0.653179591,111144,58571,169715,1823,1808,3631,1,1,135233,660,124596,259829
Not considered,Above average state,DAMAN & DIU,60-69,0,DAMAN & DIU,AP,25,B0101,Urban,Acceptable Performance,0.274203623,227,1090,1317,8,5,13,37,27,64,7,7,14,0.709556527,2339,1069,3408,32,16,48,1,2,2610,588,2193,4803
Not considered,Above average state,GUJARAT,60-69,0,GUJARAT,AP,24,B0101,Urban,Acceptable Performance,0.277027559,40496,282937,323433,1964,3040,5004,11732,14612,26344,1807,2483,4290,0.696733738,530175,283270,813445,6375,5491,11866,1,1,584210,603,583302,1167512
Not considered,Above average state,MEGHALAYA,60-69,0,MEGHALAYA,AP,17,B0101,Urban,Acceptable Performance,0.354273192,2014,4291,6305,41,60,101,277,338,615,50,38,88,0.606225768,7097,3692,10789,165,147,312,1,1,9438,660,8359,17797
Not considered,Above average state,MIZORAM,60-69,0,MIZORAM,AP,15,B0101,Urban,Acceptable Performance,0.460163529,3341,6339,9680,138,112,250,819,575,1394,170,143,313,0.458689865,6450,3199,9649,218,114,332,1,1,10780,657,10256,21036
Not considered,Above average state,RAJASTHAN,60-69,0,RAJASTHAN,AP,8,B0101,Urban,Acceptable Performance,0.290481738,28156,179790,207946,2794,5198,7992,9885,13989,23874,2553,2574,5127,0.66900649,316925,161994,478919,4810,4648,9458,1,2,357519,569,358347,715866
Not considered,Above average state,TAMIL NADU,60-69,0,TAMIL NADU,AP,33,B0101,Urban,Acceptable Performance,0.341636368,173456,558997,732453,4266,7433,11699,30579,46463,77042,7685,10303,17988,0.614039007,874845,441627,1316472,14806,11006,25812,1,1,1086565,610,1057390,2143955
Not considered,Above average state,TRIPURA,60-69,0,TRIPURA,AP,16,B0101,Urban,Acceptable Performance,0.235307088,1589,10150,11739,450,556,1006,672,1001,1673,372,317,689,0.717346857,21607,14180,35787,1744,1262,3006,1,2,24240,582,25648,49888
Not considered,Above average state,ANDAMAN & NICOBAR ISLANDS,60+,0,ANDAMAN & NICOBAR ISLANDS,AP,35,B0101,Urban,Acceptable Performance,0.184235137,174,1205,1379,5,24,29,33,92,125,2,26,28,0.795323981,3094,2859,5953,61,64,125,1,2,3303,593,4182,7485
Not considered,Above average state,ANDHRA PRADESH,60+,0,ANDHRA PRADESH,AP,28,B0101,Urban,Acceptable Performance,0.257697855,120748,438495,559243,9349,14274,23623,38927,52438,91365,6651,8992,15643,0.692993111,970374,533525,1503899,23365,17149,40514,1,1,1136700,635,1033450,2170150
Not considered,Above average state,CHHATTISGARH,60+,0,CHHATTISGARH,AP,22,B0101,Urban,Acceptable Performance,0.250223257,22489,78942,101431,1896,2868,4764,6107,7233,13340,1873,1654,3527,0.708167021,182183,104881,287064,2552,2449,5001,1,1,212652,660,192710,405362
Not considered,Above average state,DAMAN & DIU,60+,0,DAMAN & DIU,AP,25,B0101,Urban,Acceptable Performance,0.225764978,280,1476,1756,8,5,13,44,33,77,8,9,17,0.762149653,4038,1890,5928,41,20,61,1,2,4370,588,3408,7778
Not considered,Above average state,GUJARAT,60+,0,GUJARAT,AP,24,B0101,Urban,Acceptable Performance,0.228348998,56645,377728,434373,2821,4224,7045,17147,21357,38504,2637,3676,6313,0.748090796,907461,515582,1423043,8870,7575,16445,1,1,983890,603,918343,1902233
Not considered,Above average state,MEGHALAYA,60+,0,MEGHALAYA,AP,17,B0101,Urban,Acceptable Performance,0.293376897,2766,5854,8620,71,79,150,407,488,895,68,67,135,0.671567626,13094,6638,19732,214,186,400,1,1,16335,660,13047,29382
Not considered,Above average state,MIZORAM,60+,0,MIZORAM,AP,15,B0101,Urban,Acceptable Performance,0.353592383,4314,8462,12776,174,161,335,1131,891,2022,288,248,536,0.575611646,12815,7983,20798,281,161,442,1,1,18548,657,17584,36132
Not considered,Above average state,RAJASTHAN,60+,0,RAJASTHAN,AP,8,B0101,Urban,Acceptable Performance,0.237264231,37801,244151,281952,3656,6927,10583,13334,20128,33462,3572,4209,7781,0.728029547,554044,311107,865151,6827,6373,13200,1,2,608751,569,579595,1188346
Not considered,Above average state,TAMIL NADU,60+,0,TAMIL NADU,AP,33,B0101,Urban,Acceptable Performance,0.282250412,229374,753044,982418,5796,9797,15593,42875,66793,109668,10644,15188,25832,0.678820201,1510328,852415,2362743,18902,13764,32666,1,1,1793221,610,1687440,3480661
Not considered,Above average state,TRIPURA,60+,0,TRIPURA,AP,16,B0101,Urban,Acceptable Performance,0.191678304,2162,13897,16059,604,779,1383,936,1521,2457,514,474,988,0.767202588,39592,24685,64277,2315,1588,3903,1,2,43204,582,40577,83781
Not considered,Above average state,ANDAMAN & NICOBAR ISLANDS,70-79,0,ANDAMAN & NICOBAR ISLANDS,AP,35,B0101,Urban,Acceptable Performance,0.114254625,25,185,210,1,1,2,7,22,29,0,3,3,0.868335147,772,824,1596,13,11,24,1,2,804,593,1034,1838
Not considered,Above average state,ANDHRA PRADESH,70-79,0,ANDHRA PRADESH,AP,28,B0101,Urban,Acceptable Performance,0.186969257,19651,82862,102513,1508,2623,4131,7091,11371,18462,1177,1989,3166,0.773584321,257695,166452,424147,3857,2962,6819,1,1,285614,635,262674,548288
Not considered,Above average state,CHHATTISGARH,70-79,0,CHHATTISGARH,AP,22,B0101,Urban,Acceptable Performance,0.171850549,3577,14982,18559,280,475,755,1045,1566,2611,370,425,795,0.796610954,51201,34829,86030,479,436,915,1,1,56193,660,51802,107995
Not considered,Above average state,DAMAN & DIU,70-79,0,DAMAN & DIU,AP,25,B0101,Urban,Acceptable Performance,0.136634571,42,256,298,0,0,0,4,5,9,0,1,1,0.858780376,1244,629,1873,7,2,9,1,2,1290,588,891,2181
Not considered,Above average state,GUJARAT,70-79,0,GUJARAT,AP,24,B0101,Urban,Acceptable Performance,0.157076827,11494,69863,81357,589,806,1395,3787,4894,8681,611,886,1497,0.8232724,258334,168075,426409,1740,1496,3236,1,1,274226,603,243718,517944
Not considered,Above average state,MEGHALAYA,70-79,0,MEGHALAYA,AP,17,B0101,Urban,Acceptable Performance,0.214856129,567,1128,1695,19,13,32,99,109,208,10,20,30,0.754975282,3929,2027,5956,35,24,59,1,1,4605,660,3284,7889
Not considered,Above average state,MIZORAM,70-79,0,MIZORAM,AP,15,B0101,Urban,Acceptable Performance,0.243017022,837,1747,2584,28,38,66,262,251,513,100,80,180,0.691808521,4225,3131,7356,34,25,59,1,1,5424,657,5209,10633
Not considered,Above average state,RAJASTHAN,70-79,0,RAJASTHAN,AP,8,B0101,Urban,Acceptable Performance,0.172422556,7322,50353,57675,632,1333,1965,2625,4801,7426,805,1238,2043,0.799269353,162189,105165,267354,1365,1227,2592,1,2,172941,569,161557,334498
Not considered,Above average state,TAMIL NADU,70-79,0,TAMIL NADU,AP,33,B0101,Urban,Acceptable Performance,0.211690603,45872,161661,207533,1151,1905,3056,9574,16251,25825,2401,3983,6384,0.755455139,446875,293743,740618,3283,2252,5535,1,1,504722,610,475638,980360
Not considered,Above average state,TRIPURA,70-79,0,TRIPURA,AP,16,B0101,Urban,Acceptable Performance,0.144159107,433,2952,3385,108,169,277,195,392,587,107,114,221,0.821430092,11908,7380,19288,402,261,663,1,2,12643,582,10838,23481
Not considered,Above average state,ANDAMAN & NICOBAR ISLANDS,80+,0,ANDAMAN & NICOBAR ISLANDS,AP,35,B0101,Urban,Acceptable Performance,0.13961039,21,65,86,1,3,4,2,9,11,0,1,1,0.840909091,306,212,518,7,2,9,1,2,329,593,287,616
Not considered,Above average state,ANDHRA PRADESH,80+,0,ANDHRA PRADESH,AP,28,B0101,Urban,Acceptable Performance,0.166033646,8544,28220,36764,870,1116,1986,3717,4288,8005,440,608,1048,0.793081179,117030,58578,175608,1272,851,2123,1,1,129731,635,91694,221425
Not considered,Above average state,CHHATTISGARH,80+,0,CHHATTISGARH,AP,22,B0101,Urban,Acceptable Performance,0.141936171,1016,4312,5328,86,147,233,294,399,693,78,120,198,0.834327881,19838,11481,31319,250,205,455,1,1,21226,660,16312,37538
Not considered,Above average state,DAMAN & DIU,80+,0,DAMAN & DIU,AP,25,B0101,Urban,Acceptable Performance,0.177581864,11,130,141,0,0,0,3,1,4,1,1,2,0.814861461,455,192,647,2,2,4,1,2,470,588,324,794
Not considered,Above average state,GUJARAT,80+,0,GUJARAT,AP,24,B0101,Urban,Acceptable Performance,0.13646743,4655,24928,29583,268,378,646,1628,1851,3479,219,307,526,0.845057363,118952,64237,183189,755,588,1343,1,1,125454,603,91323,216777
Not considered,Above average state,MEGHALAYA,80+,0,MEGHALAYA,AP,17,B0101,Urban,Acceptable Performance,0.167748918,185,435,620,11,6,17,31,41,72,8,9,17,0.808170996,2068,919,2987,14,15,29,1,1,2292,660,1404,3696
Not considered,Above average state,MIZORAM,80+,0,MIZORAM,AP,15,B0101,Urban,Acceptable Performance,0.11472104,136,376,512,8,11,19,50,65,115,18,25,43,0.849876765,2140,1653,3793,29,22,51,1,1,2344,657,2119,4463
Not considered,Above average state,RAJASTHAN,80+,0,RAJASTHAN,AP,8,B0101,Urban,Acceptable Performance,0.118356017,2323,14008,16331,230,396,626,824,1338,2162,214,397,611,0.861547158,74930,43948,118878,652,498,1150,1,2,78291,569,59691,137982
Not considered,Above average state,TAMIL NADU,80+,0,TAMIL NADU,AP,33,B0101,Urban,Acceptable Performance,0.119075281,10046,32386,42432,379,459,838,2722,4079,6801,558,902,1460,0.857742194,188608,117045,305653,813,506,1319,1,1,201934,610,154412,356346
Not considered,Above average state,TRIPURA,80+,0,TRIPURA,AP,16,B0101,Urban,Acceptable Performance,0.089800231,140,795,935,46,54,100,69,128,197,35,43,78,0.883787937,6077,3125,9202,169,65,234,1,2,6321,582,4091,10412
Not considered,Above average state,ANDAMAN & NICOBAR ISLANDS,Age not stated,0,ANDAMAN & NICOBAR ISLANDS,AP,35,B0101,Urban,Acceptable Performance,0.303191489,12,45,57,1,6,7,2,4,6,1,2,3,0.64893617,79,43,122,13,4,17,1,2,94,593,94,188
Not considered,Above average state,ANDHRA PRADESH,Age not stated,0,ANDHRA PRADESH,AP,28,B0101,Urban,Acceptable Performance,0.26217523,22699,74304,97003,2984,4254,7238,10333,13020,23353,829,1281,2110,0.669004549,150060,97467,247527,4455,3989,8444,1,1,183921,635,186072,369993
Not considered,Above average state,CHHATTISGARH,Age not stated,0,CHHATTISGARH,AP,22,B0101,Urban,Acceptable Performance,0.281441718,552,2017,2569,51,119,170,145,258,403,16,28,44,0.669588081,3550,2562,6112,112,109,221,1,1,4263,660,4865,9128
Not considered,Above average state,DAMAN & DIU,Age not stated,0,DAMAN & DIU,AP,25,B0101,Urban,Acceptable Performance,0.600732601,9,155,164,1,1,2,1,11,12,0,0,0,0.355311355,58,39,97,2,2,4,1,2,68,588,205,273
Not considered,Above average state,GUJARAT,Age not stated,0,GUJARAT,AP,24,B0101,Urban,Acceptable Performance,0.305589386,4873,32764,37637,390,579,969,1872,2633,4505,169,269,438,0.654276481,49975,30607,80582,874,877,1751,1,1,56889,603,66273,123162
Not considered,Above average state,MEGHALAYA,Age not stated,0,MEGHALAYA,AP,17,B0101,Urban,Acceptable Performance,0.647058824,72,577,649,2,4,6,14,31,45,2,0,2,0.306081755,187,120,307,4,1,5,1,1,275,660,728,1003
Not considered,Above average state,MIZORAM,Age not stated,0,MIZORAM,AP,15,B0101,Urban,Acceptable Performance,0.246458924,26,61,87,4,4,8,8,14,22,2,9,11,0.660056657,92,141,233,9,8,17,1,1,128,657,225,353
Not considered,Above average state,RAJASTHAN,Age not stated,0,RAJASTHAN,AP,8,B0101,Urban,Acceptable Performance,0.27774653,2196,13112,15308,351,611,962,823,1225,2048,180,169,349,0.678762587,23057,14353,37410,925,859,1784,1,2,26256,569,28859,55115
Not considered,Above average state,TAMIL NADU,Age not stated,0,TAMIL NADU,AP,33,B0101,Urban,Acceptable Performance,0.254882939,2220,5662,7882,170,187,357,529,715,1244,62,79,141,0.700329841,12063,9594,21657,247,347,594,1,1,14874,610,16050,30924
Not considered,Above average state,TRIPURA,Age not stated,0,TRIPURA,AP,16,B0101,Urban,Acceptable Performance,0.237521515,27,111,138,9,5,14,16,16,32,1,2,3,0.702237522,238,170,408,45,22,67,1,2,282,582,299,581
Not considered,Above average state,ANDAMAN & NICOBAR ISLANDS,Oct-14,0,ANDAMAN & NICOBAR ISLANDS,AP,35,B0101,Urban,Acceptable Performance,0.019851319,99,144,243,26,20,46,55,64,119,1,0,1,0.97034556,5699,6179,11878,346,372,718,1,2,5854,593,6387,12241
Not considered,Above average state,ANDHRA PRADESH,Oct-14,0,ANDHRA PRADESH,AP,28,B0101,Urban,Acceptable Performance,0.025382815,23821,43093,66914,7540,9003,16543,27685,30562,58247,1410,1989,3399,0.951232706,1234253,1273380,2507633,15983,18015,33998,1,1,1287169,635,1349024,2636193
Not considered,Above average state,CHHATTISGARH,Oct-14,0,CHHATTISGARH,AP,22,B0101,Urban,Acceptable Performance,0.015767532,3083,6289,9372,674,941,1615,1868,2241,4109,1070,1378,2448,0.973200917,282254,296203,578457,3625,5044,8669,1,1,288275,660,306111,594386
Not considered,Above average state,DAMAN & DIU,Oct-14,0,DAMAN & DIU,AP,25,B0101,Urban,Acceptable Performance,0.051884216,111,459,570,3,12,15,11,28,39,3,12,15,0.943200437,4863,5499,10362,80,106,186,1,2,4988,588,5998,10986
Not considered,Above average state,GUJARAT,Oct-14,0,GUJARAT,AP,24,B0101,Urban,Acceptable Performance,0.030735987,17872,54713,72585,2761,4237,6998,10838,13402,24240,1628,2001,3629,0.957462936,1036771,1224339,2261110,12585,18264,30849,1,1,1067109,603,1294455,2361564
Not considered,Above average state,MEGHALAYA,Oct-14,0,MEGHALAYA,AP,17,B0101,Urban,Acceptable Performance,0.015733278,447,611,1058,216,221,437,430,442,872,85,106,191,0.968459091,32595,32530,65125,716,732,1448,1,1,33557,660,33689,67246
Not considered,Above average state,MIZORAM,Oct-14,0,MIZORAM,AP,15,B0101,Urban,Acceptable Performance,0.010229729,255,327,582,78,103,181,233,218,451,336,371,707,0.969416273,27379,27774,55153,971,997,1968,1,1,28203,657,28690,56893
Not considered,Above average state,RAJASTHAN,Oct-14,0,RAJASTHAN,AP,8,B0101,Urban,Acceptable Performance,0.017770566,9402,23355,32757,2550,4415,6965,7167,8888,16055,1896,2192,4088,0.971301922,840900,949529,1790429,14174,20743,34917,1,2,859365,569,983964,1843329
Not considered,Above average state,TAMIL NADU,Oct-14,0,TAMIL NADU,AP,33,B0101,Urban,Acceptable Performance,0.015310335,15958,27713,43671,5223,5808,11031,18230,19260,37490,728,964,1692,0.9709531,1354647,1414887,2769534,14733,17011,31744,1,1,1389563,610,1462824,2852387
Not considered,Above average state,TRIPURA,Oct-14,0,TRIPURA,AP,16,B0101,Urban,Acceptable Performance,0.010321838,204,567,771,121,184,305,218,281,499,45,73,118,0.981418014,36132,37176,73308,1754,1860,3614,1,2,36599,582,38097,74696
Not considered,Above average state,ANDAMAN & NICOBAR ISLANDS,Total,0,ANDAMAN & NICOBAR ISLANDS,AP,35,B0101,Urban,Acceptable Performance,0.373160125,10336,43208,53544,945,1999,2944,1327,2576,3903,184,435,619,0.595325045,55057,30365,85422,11312,5342,16654,1,2,66904,593,76584,143488
Not considered,Above average state,ANDHRA PRADESH,Total,0,ANDHRA PRADESH,AP,28,B0101,Urban,Acceptable Performance,0.315191409,2020246,6874164,8894410,213115,315342,528457,586564,715357,1301921,76383,97885,174268,0.632496848,11336977,6511499,17848476,826790,602261,1429051,1,1,14020170,635,14198905,28219075
Not considered,Above average state,CHHATTISGARH,Total,0,CHHATTISGARH,AP,22,B0101,Urban,Acceptable Performance,0.316046504,393020,1483423,1876443,46170,73613,119783,89832,104926,194758,22651,23259,45910,0.643418142,2396265,1423861,3820126,159334,133065,292399,1,1,2901768,660,3035469,5937237
Not considered,Above average state,DAMAN & DIU,Total,0,DAMAN & DIU,AP,25,B0101,Urban,Acceptable Performance,0.519548704,8517,86483,95000,260,570,830,714,1362,2076,165,727,892,0.464219501,55549,29334,84883,3293,1810,5103,1,2,64945,588,117906,182851
Not considered,Above average state,GUJARAT,Total,0,GUJARAT,AP,24,B0101,Urban,Acceptable Performance,0.329665047,1060898,7426356,8487254,66521,124625,191146,270661,355401,626062,36766,47573,84339,0.642741295,10684657,5862771,16547428,333837,276030,609867,1,1,12052982,603,13692101,25745083
Not considered,Above average state,MEGHALAYA,Total,0,MEGHALAYA,AP,17,B0101,Urban,Acceptable Performance,0.320120917,60526,130090,190616,4185,5317,9502,8265,10101,18366,1473,1706,3179,0.643696364,227614,155675,383289,26199,17484,43683,1,1,297878,660,297572,595450
Not considered,Above average state,MIZORAM,Total,0,MIZORAM,AP,15,B0101,Urban,Acceptable Performance,0.344903816,68789,128417,197206,6077,7541,13618,15700,12881,28581,4185,4351,8536,0.590180334,196893,140555,337448,23082,16394,39476,1,1,285567,657,286204,571771
Not considered,Above average state,RAJASTHAN,Total,0,RAJASTHAN,AP,8,B0101,Urban,Acceptable Performance,0.286520451,710925,4173700,4884625,88278,184734,273012,221421,301993,523414,47069,45914,92983,0.677323171,7159420,4387643,11547063,398775,348008,746783,1,2,8138835,569,8909250,17048085
Not considered,Above average state,TAMIL NADU,Total,0,TAMIL NADU,AP,33,B0101,Urban,Acceptable Performance,0.360938975,3194345,9408720,12603065,187588,284163,471751,516215,692356,1208571,92348,119367,211715,0.598385477,13655622,7238467,20894089,1137154,661387,1798541,1,1,17458530,610,17458910,34917440
Not considered,Above average state,TRIPURA,Total,0,TRIPURA,AP,16,B0101,Urban,Acceptable Performance,0.312481213,49578,250858,300436,18308,19934,38242,18031,22002,40033,8277,4699,12976,0.632384526,398364,209644,608008,131474,47391,178865,1,2,474250,582,487203,961453
Optimum Performing/Ideal role models,Above average state,HIMACHAL PRADESH,15-19,0,HIMACHAL PRADESH,AP,2,B0101,Urban,Acceptable Performance,0.095656895,942,5225,6167,374,820,1194,580,1059,1639,277,440,717,0.867798976,26496,29451,55947,3808,5187,8995,1,1,28295,696,36175,64470
Optimum Performing/Ideal role models,Above average state,SIKKIM,15-19,0,SIKKIM,AP,11,B0101,Urban,Acceptable Performance,0.128631475,693,1388,2081,102,114,216,270,411,681,58,96,154,0.819755223,7102,6160,13262,984,896,1880,1,1,8123,741,8055,16178
Optimum Performing/Ideal role models,Above average state,HIMACHAL PRADESH,15-59,0,HIMACHAL PRADESH,AP,2,B0101,Urban,Acceptable Performance,0.476995484,47026,180705,227731,4268,7782,12050,9424,11513,20937,2794,2409,5203,0.468252805,159578,63979,223557,33288,20020,53308,1,1,218822,696,258606,477428
Optimum Performing/Ideal role models,Above average state,SIKKIM,15-59,0,SIKKIM,AP,11,B0101,Urban,Acceptable Performance,0.498872329,14611,39582,54193,767,1093,1860,2197,3527,5724,420,622,1042,0.438843424,34107,13565,47672,5920,3501,9421,1,1,51335,741,57296,108631
Optimum Performing/Ideal role models,Above average state,HIMACHAL PRADESH,20-24,0,HIMACHAL PRADESH,AP,2,B0101,Urban,Acceptable Performance,0.299160833,3525,17544,21069,963,1543,2506,1303,1959,3262,394,551,945,0.641103554,26652,18499,45151,9003,8124,17127,1,1,31874,696,38553,70427
Optimum Performing/Ideal role models,Above average state,SIKKIM,20-24,0,SIKKIM,AP,11,B0101,Urban,Acceptable Performance,0.324034826,1423,4234,5657,199,273,472,408,683,1091,77,138,215,0.601157063,6705,3790,10495,1805,1359,3164,1,1,8613,741,8845,17458
Optimum Performing/Ideal role models,Above average state,HIMACHAL PRADESH,25-29,0,HIMACHAL PRADESH,AP,2,B0101,Urban,Acceptable Performance,0.493005873,6137,26182,32319,909,1511,2420,1476,1986,3462,391,371,762,0.442559683,22442,6570,29012,7635,3779,11414,1,1,30446,696,35109,65555
Optimum Performing/Ideal role models,Above average state,SIKKIM,25-29,0,SIKKIM,AP,11,B0101,Urban,Acceptable Performance,0.520293154,2625,6746,9371,199,279,478,398,753,1151,87,104,191,0.405196824,5676,1622,7298,1576,801,2377,1,1,8786,741,9225,18011
Optimum Performing/Ideal role models,Above average state,HIMACHAL PRADESH,30-34,0,HIMACHAL PRADESH,AP,2,B0101,Urban,Acceptable Performance,0.565593126,6884,27607,34491,748,1120,1868,1494,1629,3123,429,270,699,0.371732642,20194,2475,22669,5376,1317,6693,1,1,29001,696,31981,60982
Optimum Performing/Ideal role models,Above average state,SIKKIM,30-34,0,SIKKIM,AP,11,B0101,Urban,Acceptable Performance,0.616012962,2549,6576,9125,107,167,274,310,526,836,52,89,141,0.318031459,4128,583,4711,751,242,993,1,1,7039,741,7774,14813
Optimum Performing/Ideal role models,Above average state,HIMACHAL PRADESH,35-39,0,HIMACHAL PRADESH,AP,2,B0101,Urban,Acceptable Performance,0.596905829,7852,27181,35033,585,1013,1598,1452,1489,2941,449,229,678,0.341432247,18614,1425,20039,3933,599,4532,1,1,28367,696,30324,58691
Optimum Performing/Ideal role models,Above average state,SIKKIM,35-39,0,SIKKIM,AP,11,B0101,Urban,Acceptable Performance,0.65902827,2341,6028,8369,70,104,174,287,364,651,36,58,94,0.282305693,3252,333,3585,473,109,582,1,1,5916,741,6783,12699
Optimum Performing/Ideal role models,Above average state,HIMACHAL PRADESH,40-49,0,HIMACHAL PRADESH,AP,2,B0101,Urban,Acceptable Performance,0.636531598,13979,46657,60636,531,1250,1781,2023,2164,4187,582,322,904,0.310025194,27391,2142,29533,2926,620,3546,1,1,43975,696,51285,95260
Optimum Performing/Ideal role models,Above average state,SIKKIM,40-49,0,SIKKIM,AP,11,B0101,Urban,Acceptable Performance,0.682376722,3364,9464,12828,69,100,169,368,507,875,73,89,162,0.262460769,4506,428,4934,288,61,349,1,1,8311,741,10488,18799
Optimum Performing/Ideal role models,Above average state,HIMACHAL PRADESH,5-Sep,0,HIMACHAL PRADESH,AP,2,B0101,Urban,Acceptable Performance,0.008448655,178,275,453,38,52,90,139,183,322,66,72,138,0.982972136,24219,28486,52705,245,328,573,1,1,24602,696,29016,53618
Optimum Performing/Ideal role models,Above average state,SIKKIM,5-Sep,0,SIKKIM,AP,11,B0101,Urban,Acceptable Performance,0.004952077,30,32,62,15,15,30,75,81,156,3,4,7,0.982028754,6058,6237,12295,116,107,223,1,1,6166,741,6354,12520
Optimum Performing/Ideal role models,Above average state,HIMACHAL PRADESH,50-59,0,HIMACHAL PRADESH,AP,2,B0101,Urban,Acceptable Performance,0.612736328,7707,30309,38016,158,525,683,1096,1227,2323,272,226,498,0.341795207,17789,3417,21206,607,394,1001,1,1,26864,696,35179,62043
Optimum Performing/Ideal role models,Above average state,SIKKIM,50-59,0,SIKKIM,AP,11,B0101,Urban,Acceptable Performance,0.633561323,1616,5146,6762,21,56,77,156,283,439,37,48,85,0.317342828,2738,649,3387,43,33,76,1,1,4547,741,6126,10673
Optimum Performing/Ideal role models,Above average state,HIMACHAL PRADESH,60-69,0,HIMACHAL PRADESH,AP,2,B0101,Urban,Acceptable Performance,0.239784946,1213,6369,7582,50,210,260,476,726,1202,152,146,298,0.712776724,13209,9329,22538,241,299,540,1,1,15050,696,16570,31620
Optimum Performing/Ideal role models,Above average state,SIKKIM,60-69,0,SIKKIM,AP,11,B0101,Urban,Acceptable Performance,0.315823606,276,1185,1461,8,29,37,69,144,213,14,41,55,0.626242974,1788,1109,2897,41,32,73,1,1,2147,741,2479,4626
Optimum Performing/Ideal role models,Above average state,HIMACHAL PRADESH,60+,0,HIMACHAL PRADESH,AP,2,B0101,Urban,Acceptable Performance,0.203827466,1718,9231,10949,80,269,349,680,1025,1705,230,238,468,0.755719791,23645,16950,40595,341,367,708,1,1,26273,696,27444,53717
Optimum Performing/Ideal role models,Above average state,SIKKIM,60+,0,SIKKIM,AP,11,B0101,Urban,Acceptable Performance,0.262976695,369,1617,1986,11,38,49,100,198,298,15,60,75,0.687632415,3072,2121,5193,50,40,90,1,1,3556,741,3996,7552
Optimum Performing/Ideal role models,Above average state,HIMACHAL PRADESH,70-79,0,HIMACHAL PRADESH,AP,2,B0101,Urban,Acceptable Performance,0.160098682,331,2135,2466,22,46,68,165,235,400,57,70,127,0.805687204,7102,5308,12410,62,54,116,1,1,7655,696,7748,15403
Optimum Performing/Ideal role models,Above average state,SIKKIM,70-79,0,SIKKIM,AP,11,B0101,Urban,Acceptable Performance,0.185346919,62,320,382,2,6,8,24,38,62,1,17,18,0.775836972,888,711,1599,5,7,12,1,1,975,741,1086,2061
Optimum Performing/Ideal role models,Above average state,HIMACHAL PRADESH,80+,0,HIMACHAL PRADESH,AP,2,B0101,Urban,Acceptable Performance,0.134598148,174,727,901,8,13,21,39,64,103,21,22,43,0.843591276,3334,2313,5647,38,14,52,1,1,3568,696,3126,6694
Optimum Performing/Ideal role models,Above average state,SIKKIM,80+,0,SIKKIM,AP,11,B0101,Urban,Acceptable Performance,0.165317919,31,112,143,1,3,4,7,16,23,0,2,2,0.805780347,396,301,697,4,1,5,1,1,434,741,431,865
Optimum Performing/Ideal role models,Above average state,HIMACHAL PRADESH,Age not stated,0,HIMACHAL PRADESH,AP,2,B0101,Urban,Acceptable Performance,0.392535393,55,250,305,0,7,7,2,17,19,2,6,8,0.572715573,264,181,445,26,10,36,1,1,323,696,454,777
Optimum Performing/Ideal role models,Above average state,SIKKIM,Age not stated,0,SIKKIM,AP,11,B0101,Urban,Acceptable Performance,0.328042328,8,54,62,1,4,5,2,6,8,0,1,1,0.624338624,73,45,118,9,2,11,1,1,83,741,106,189
Optimum Performing/Ideal role models,Above average state,HIMACHAL PRADESH,Oct-14,0,HIMACHAL PRADESH,AP,2,B0101,Urban,Acceptable Performance,0.016180736,300,654,954,77,119,196,246,279,525,163,158,321,0.96947031,25510,31649,57159,468,618,1086,1,1,26219,696,32740,58959
Optimum Performing/Ideal role models,Above average state,SIKKIM,Oct-14,0,SIKKIM,AP,11,B0101,Urban,Acceptable Performance,0.027966332,198,214,412,21,29,50,130,137,267,23,37,60,0.949837089,7004,6989,13993,184,165,349,1,1,7355,741,7377,14732
Optimum Performing/Ideal role models,Above average state,HIMACHAL PRADESH,Total,0,HIMACHAL PRADESH,AP,2,B0101,Urban,Acceptable Performance,0.349126863,49277,191115,240392,4463,8229,12692,10491,13017,23508,3255,2883,6138,0.607817565,254001,164513,418514,34368,21343,55711,1,1,317024,696,371528,688552
Optimum Performing/Ideal role models,Above average state,SIKKIM,Total,0,SIKKIM,AP,11,B0101,Urban,Acceptable Performance,0.369291175,15216,41499,56715,815,1179,1994,2504,3949,6453,461,724,1185,0.58097514,55124,34101,89225,6279,3815,10094,1,1,73305,741,80273,153578
Not considered,Below average state,INDIA,15-19,0,,,0,B0101,Rural,,0.158106569,4052275,9213257,13265532,2071330,3610314,5681644,3648408,4499043,8147451,1328533,1483554,2812087,0.711271082,30302699,29374703,59677402,4602215,5709844,10312059,1,,39331915,558,44570557,83902472
Not considered,Below average state,INDIA,15-59,0,,,0,B0101,Rural,,0.447774633,60146149,156551166,216697315,17949854,26335666,44285520,37991706,34551256,72542962,9079889,6723939,15803828,0.369669107,128824526,50074181,178898707,20807811,13421687,34229498,1,,236042270,558,247900542,483942812
Not considered,Below average state,INDIA,20-24,0,,,0,B0101,Rural,,0.365277134,7511066,19459188,26970254,3034649,5197306,8231955,5562418,6183866,11746284,1387294,1280766,2668060,0.439499259,21235606,11214842,32450448,4950303,4472469,9422772,1,,35696384,558,38138662,73835046
Not considered,Below average state,INDIA,25-29,0,,,0,B0101,Rural,,0.484958347,8704025,23336334,32040359,2924592,4448826,7373418,5719248,5538638,11257886,1293931,941150,2235081,0.310814011,16975077,3559867,20534944,3549786,1665344,5215130,1,,32692281,558,33375989,66068270
Not considered,Below average state,INDIA,30-34,0,,,0,B0101,Rural,,0.531405934,8567249,22207414,30774663,2578698,3481314,6060012,5346690,4478125,9824815,1167979,715254,1883233,0.266423658,13895669,1533399,15429068,2411528,618714,3030242,1,,28977587,558,28934192,57911779
Not considered,Below average state,INDIA,35-39,0,,,0,B0101,Rural,,0.558691431,8975053,22346701,31321754,2427695,3113522,5541217,5214277,4111518,9325795,1113847,652304,1766151,0.24345965,12633969,1015038,13649007,1989412,341982,2331394,1,,27937146,558,28125561,56062707
Not considered,Below average state,INDIA,40-49,0,,,0,B0101,Rural,,0.576130114,14015779,36838786,50854565,3291257,4289468,7580725,7857179,6083685,13940864,1676538,983363,2659901,0.235800228,19290235,1523671,20813906,2290505,377721,2668226,1,,42839731,558,45429505,88269236
Not considered,Below average state,INDIA,5-Sep,0,,,0,B0101,Rural,,0.008611391,355472,452342,807814,107671,126235,233906,358861,379884,738745,168939,170481,339420,0.979895246,44099081,47822552,91921633,363359,406387,769746,1,,44982353,558,48825259,93807612
Not considered,Below average state,INDIA,50-59,0,,,0,B0101,Rural,,0.543589447,8320702,23149486,31470188,1621633,2194916,3816549,4643486,3656381,8299867,1111767,667548,1779315,0.282311277,14491271,1852661,16343932,1014062,235613,1249675,1,,28567226,558,29326076,57893302
Not considered,Below average state,INDIA,60-69,0,,,0,B0101,Rural,,0.405031641,4662834,13647640,18310474,773579,1252261,2025840,2620422,2680342,5300764,812489,658568,1471057,0.445174215,14971867,5153353,20125220,551111,250171,801282,1,,23067612,558,22139903,45207515
Not considered,Below average state,INDIA,60+,0,,,0,B0101,Rural,,0.343023072,6079316,19062156,25141472,967846,1656283,2624129,3393633,3811315,7204948,1112755,1037451,2150206,0.529337875,26710816,12086380,38797196,733958,371815,1105773,1,,37296520,558,35997302,73293822
Not considered,Below average state,INDIA,70-79,0,,,0,B0101,Rural,,0.270247949,1117044,4339618,5456662,147436,316068,463504,604943,894517,1499460,237969,294673,532642,0.629109681,8139758,4562795,12702553,137791,91875,229666,1,,10099714,558,10091603,20191317
Not considered,Below average state,INDIA,80+,0,,,0,B0101,Rural,,0.174076978,299438,1074898,1374336,46831,87954,134785,168268,236456,404724,62297,84210,146507,0.756102668,3599191,2370232,5969423,45056,29769,74825,1,,4129194,558,3765796,7894990
Not considered,Below average state,INDIA,Age not stated,0,,,0,B0101,Rural,,0.261073119,221225,539399,760624,50165,79866,130031,139563,143913,283476,29561,26359,55920,0.622434143,989683,823749,1813432,33330,30768,64098,1,,1380032,558,1533420,2913452
Not considered,Below average state,INDIA,Oct-14,0,,,0,B0101,Rural,,0.025424398,970929,1490267,2461196,454503,604721,1059224,1123669,1158211,2281880,734412,738874,1473286,0.935784366,43487326,47100806,90588132,944737,1140156,2084893,1,,46316336,558,50488158,96804494
Not considered,Below average state,INDIA,Total,0,,,0,B0101,Rural,,0.294895064,67773091,178095330,245868421,19530039,28802771,48332810,43007432,40044579,83052011,11125556,8697104,19822660,0.581716855,284061715,200944045,485005760,22883195,15370813,38254008,1,,405967794,558,427781058,833748852
Can be easily improved,Below average state,ARUNACHAL PRADESH,15-19,0,UP,ARUNACHAL PRADESH,12,B0101,Rural,Underperformance,0.144592639,7952,8830,16782,2675,2664,5339,4433,4020,8453,1753,1646,3399,0.753291288,42965,44465,87430,8159,8757,16916,1,3,57103,563,58961,116064
Can be easily improved,Below average state,WEST BENGAL,15-19,0,UP,WEST BENGAL,19,B0101,Rural,Underperformance,0.134902242,148632,720502,869134,207698,442432,650130,217816,418722,636538,89022,137815,226837,0.731089397,2627621,2082565,4710186,1129448,988151,2117599,1,3,3083091,560,3359604,6442695
Can be easily improved,Below average state,ARUNACHAL PRADESH,15-59,0,UP,ARUNACHAL PRADESH,12,B0101,Rural,Underperformance,0.557411695,140040,202577,342617,17160,16072,33232,36468,27608,64076,7702,5603,13305,0.316695328,114112,80547,194659,25669,21557,47226,1,3,298322,563,316335,614657
Can be easily improved,Below average state,WEST BENGAL,15-59,0,UP,WEST BENGAL,19,B0101,Rural,Underperformance,0.385936463,2276815,12805340,15082155,1878537,2948043,4826580,2319843,3005677,5325520,804855,749126,1553981,0.438024351,13507177,3610540,17117717,5661253,1977777,7639030,1,3,18908690,560,20170683,39079373
Can be easily improved,Below average state,ARUNACHAL PRADESH,20-24,0,UP,ARUNACHAL PRADESH,12,B0101,Rural,Underperformance,0.423327987,18426,23014,41440,3491,3371,6862,6049,4719,10768,1447,1159,2606,0.440050669,22946,20131,43077,7226,7095,14321,1,3,48868,563,49023,97891
Can be easily improved,Below average state,WEST BENGAL,20-24,0,UP,WEST BENGAL,19,B0101,Rural,Underperformance,0.299389133,272465,1536660,1809125,324604,609204,933808,357960,583451,941411,125260,143661,268921,0.500315007,2224364,798900,3023264,1203727,581325,1785052,1,3,2980049,560,3062672,6042721
Can be easily improved,Below average state,ARUNACHAL PRADESH,25-29,0,UP,ARUNACHAL PRADESH,12,B0101,Rural,Underperformance,0.62352773,23949,32749,56698,3187,3041,6228,6183,4703,10886,1171,792,1963,0.235167325,13654,7730,21384,4248,3358,7606,1,3,44957,563,45974,90931
Can be easily improved,Below average state,WEST BENGAL,25-29,0,UP,WEST BENGAL,19,B0101,Rural,Underperformance,0.40816277,326333,1859377,2185710,319684,496257,815941,364725,487489,852214,122666,108690,231356,0.38948974,1817777,267939,2085716,938331,203481,1141812,1,3,2631501,560,2723495,5354996
Can be easily improved,Below average state,ARUNACHAL PRADESH,30-34,0,UP,ARUNACHAL PRADESH,12,B0101,Rural,Underperformance,0.70315781,21116,31123,52239,2289,2072,4361,5001,3463,8464,903,551,1454,0.163341948,9266,2869,12135,2222,1085,3307,1,3,36286,563,38006,74292
Can be easily improved,Below average state,WEST BENGAL,30-34,0,UP,WEST BENGAL,19,B0101,Rural,Underperformance,0.457313011,322350,1713731,2036081,268809,354526,623335,321290,356446,677736,105726,77648,183374,0.349277784,1447721,107358,1555079,687839,71901,759740,1,3,2197087,560,2255183,4452270
Can be easily improved,Below average state,ARUNACHAL PRADESH,35-39,0,UP,ARUNACHAL PRADESH,12,B0101,Rural,Underperformance,0.730997281,20974,29573,50547,1960,1733,3693,4555,3213,7768,782,423,1205,0.139237577,8011,1617,9628,1631,532,2163,1,3,34322,563,34826,69148
Can be easily improved,Below average state,WEST BENGAL,35-39,0,UP,WEST BENGAL,19,B0101,Rural,Underperformance,0.476322911,361495,1828019,2189514,271485,326715,598200,338872,332472,671344,110350,74457,184807,0.337423731,1479907,71129,1551036,636570,41216,677786,1,3,2290624,560,2306077,4596701
Can be easily improved,Below average state,ARUNACHAL PRADESH,40-49,0,UP,ARUNACHAL PRADESH,12,B0101,Rural,Underperformance,0.756612303,31062,48778,79840,2412,2082,4494,6612,4604,11216,1041,645,1686,0.121120514,10712,2069,12781,1579,493,2072,1,3,49427,563,56096,105523
Can be easily improved,Below average state,WEST BENGAL,40-49,0,UP,WEST BENGAL,19,B0101,Rural,Underperformance,0.498407188,557280,3154462,3711742,345379,477160,822539,482694,515859,998553,161605,121010,282615,0.329559481,2337498,116800,2454298,765917,51689,817606,1,3,3539077,560,3908131,7447208
Can be easily improved,Below average state,ARUNACHAL PRADESH,5-Sep,0,UP,ARUNACHAL PRADESH,12,B0101,Rural,Underperformance,0.008247318,568,573,1141,312,355,667,953,933,1886,412,412,824,0.972164397,66178,68319,134497,1395,1463,2858,1,3,68111,563,70237,138348
Can be easily improved,Below average state,WEST BENGAL,5-Sep,0,UP,WEST BENGAL,19,B0101,Rural,Underperformance,0.004527131,11501,15882,27383,7515,8635,16150,14527,15618,30145,5031,4998,10029,0.988831049,2932226,3048860,5981086,60078,63775,123853,1,3,2963285,560,3085358,6048643
Can be easily improved,Below average state,ARUNACHAL PRADESH,50-59,0,UP,ARUNACHAL PRADESH,12,B0101,Rural,Underperformance,0.741201816,16561,28510,45071,1146,1109,2255,3635,2886,6521,605,387,992,0.135245362,6558,1666,8224,604,237,841,1,3,27359,563,33449,60808
Can be easily improved,Below average state,WEST BENGAL,50-59,0,UP,WEST BENGAL,19,B0101,Rural,Underperformance,0.480909517,288260,1992589,2280849,140878,241749,382627,236486,311238,547724,90226,85845,176071,0.366480686,1572289,165849,1738138,299421,40014,339435,1,3,2187261,560,2555521,4742782
Can be easily improved,Below average state,ARUNACHAL PRADESH,60-69,0,UP,ARUNACHAL PRADESH,12,B0101,Rural,Underperformance,0.595933498,7990,13230,21220,398,518,916,1717,1644,3361,429,266,695,0.290159515,7058,3274,10332,365,204,569,1,3,17194,563,18414,35608
Can be easily improved,Below average state,WEST BENGAL,60-69,0,UP,WEST BENGAL,19,B0101,Rural,Underperformance,0.310537983,111229,828726,939955,45385,92423,137808,91618,161332,252950,42458,58499,100957,0.57253986,1274174,458824,1732998,114263,43974,158237,1,3,1519479,560,1507381,3026860
Can be easily improved,Below average state,ARUNACHAL PRADESH,60+,0,UP,ARUNACHAL PRADESH,12,B0101,Rural,Underperformance,0.522524441,10736,18714,29450,550,678,1228,2370,2396,4766,664,487,1151,0.372491617,13386,7608,20994,539,323,862,1,3,27156,563,29205,56361
Can be easily improved,Below average state,WEST BENGAL,60+,0,UP,WEST BENGAL,19,B0101,Rural,Underperformance,0.253951096,146138,1097379,1243517,57282,117109,174391,117300,215763,333063,53732,81755,135487,0.650361602,2188164,996448,3184612,151770,63526,215296,1,3,2505334,560,2391345,4896679
Can be easily improved,Below average state,ARUNACHAL PRADESH,70-79,0,UP,ARUNACHAL PRADESH,12,B0101,Rural,Underperformance,0.430918753,2030,4133,6163,108,117,225,478,549,1027,162,165,327,0.474409174,4149,2636,6785,108,78,186,1,3,6819,563,7483,14302
Can be easily improved,Below average state,WEST BENGAL,70-79,0,UP,WEST BENGAL,19,B0101,Rural,Underperformance,0.17657116,25495,209868,235363,7525,17418,24943,17938,42095,60033,8501,18653,27154,0.758020472,642311,368103,1010414,25210,14289,39499,1,3,694245,560,638719,1332964
Can be easily improved,Below average state,ARUNACHAL PRADESH,80+,0,UP,ARUNACHAL PRADESH,12,B0101,Rural,Underperformance,0.320415439,716,1351,2067,44,43,87,175,203,378,73,56,129,0.600992094,2179,1698,3877,66,41,107,1,3,3143,563,3308,6451
Can be easily improved,Below average state,WEST BENGAL,80+,0,UP,WEST BENGAL,19,B0101,Rural,Underperformance,0.127034302,9414,58785,68199,4372,7268,11640,7744,12336,20080,2773,4603,7376,0.821823397,271679,169521,441200,12297,5263,17560,1,3,291610,560,245245,536855
Can be easily improved,Below average state,ARUNACHAL PRADESH,Age not stated,0,UP,ARUNACHAL PRADESH,12,B0101,Rural,Underperformance,0.336965633,175,227,402,43,33,76,74,58,132,18,20,38,0.520536463,265,356,621,19,29,48,1,3,532,563,661,1193
Can be easily improved,Below average state,WEST BENGAL,Age not stated,0,UP,WEST BENGAL,19,B0101,Rural,Underperformance,0.218618879,1834,8743,10577,1264,2014,3278,1937,2678,4615,499,617,1116,0.662925529,17744,14329,32073,2183,1303,3486,1,3,22014,560,26367,48381
Can be easily improved,Below average state,ARUNACHAL PRADESH,Oct-14,0,UP,ARUNACHAL PRADESH,12,B0101,Rural,Underperformance,0.026980704,1940,1838,3778,852,855,1707,2159,2080,4239,1246,1264,2510,0.924821105,63701,65798,129499,2742,2906,5648,1,3,69046,563,70980,140026
Can be easily improved,Below average state,WEST BENGAL,Oct-14,0,UP,WEST BENGAL,19,B0101,Rural,Underperformance,0.018848469,33282,92571,125853,41939,68086,110025,54517,77970,132487,29490,37063,66553,0.951342156,3158777,3193424,6352201,257702,286008,543710,1,3,3276066,560,3401028,6677094
Can be easily improved,Below average state,ARUNACHAL PRADESH,Total,0,UP,ARUNACHAL PRADESH,12,B0101,Rural,Underperformance,0.353903661,153459,223929,377388,18917,17993,36910,42024,33075,75099,10042,7786,17828,0.558952059,314822,281221,596043,30364,26278,56642,1,3,520347,563,546011,1066358
Can be easily improved,Below average state,WEST BENGAL,Total,0,UP,WEST BENGAL,19,B0101,Rural,Underperformance,0.265176255,2469570,14019915,16489485,1986537,3143887,5130424,2508124,3317706,5825830,893607,873559,1767166,0.612716703,24466867,13633765,38100632,6132986,2392389,8525375,1,3,30338168,560,31844945,62183113
Not considered,Below average state,ASSAM,15-19,0,UP,ASSAM,18,B0101,Rural,Underperformance,0.142101002,79471,299099,378570,76080,145587,221667,122965,184118,307083,39121,49851,88972,0.709234782,1034042,855424,1889466,268045,271586,539631,1,4,1275599,516,1388492,2664091
Not considered,Below average state,CHANDIGARH,15-19,0,UP,CHANDIGARH,4,B0101,Rural,Underperformance,0.317540687,103,775,878,5,24,29,28,40,68,10,27,37,0.644484629,837,945,1782,51,107,158,1,4,978,538,1787,2765
Not considered,Below average state,DADRA & NAGAR HAVELI,15-19,0,UP,DADRA & NAGAR HAVELI,26,B0101,Rural,Underperformance,0.293956766,1698,3891,5589,419,347,766,1175,884,2059,314,288,602,0.566086362,5051,5712,10763,520,492,1012,1,4,8238,523,10775,19013
Not considered,Below average state,DELHI,15-19,0,UP,DELHI,7,B0101,Rural,Underperformance,0.096738567,488,3804,4292,109,410,519,167,473,640,44,150,194,0.884463678,18752,20489,39241,1503,2769,4272,1,4,19451,500,24916,44367
Not considered,Below average state,GOA,15-19,0,UP,GOA,30,B0101,Rural,Underperformance,0.11193977,1783,2960,4743,728,842,1570,852,1023,1875,270,411,681,0.827735951,17466,17606,35072,4547,4442,8989,1,4,20371,535,22000,42371
Not considered,Below average state,JAMMU & KASHMIR,15-19,0,UP,JAMMU & KASHMIR,1,B0101,Rural,Underperformance,0.056248299,12387,39705,52092,30327,44894,75221,39820,45477,85297,26167,25693,51860,0.795651263,370636,366223,736859,89115,98384,187499,1,4,449010,524,477098,926108
Not considered,Below average state,JHARKHAND,15-19,0,UP,JHARKHAND,20,B0101,Rural,Underperformance,0.107377953,84801,168543,253344,121851,193933,315784,183433,218938,402371,84345,83434,167779,0.650968247,738467,797406,1535873,97932,139599,237531,1,4,1091046,529,1268321,2359367
Not considered,Below average state,KERALA,15-19,0,UP,KERALA,32,B0101,Rural,Underperformance,0.052874003,15822,56394,72216,11166,20445,31611,12716,22703,35419,2368,5780,8148,0.91522778,638703,611327,1250030,205810,204316,410126,1,4,669609,539,696204,1365813
Not considered,Below average state,LAKSHADWEEP,15-19,0,UP,LAKSHADWEEP,31,B0101,Rural,Underperformance,0.013949433,2,14,16,9,38,47,6,32,38,6,9,15,0.939843069,608,470,1078,229,171,400,1,4,622,528,525,1147
Not considered,Below average state,MADHYA PRADESH,15-19,0,UP,MADHYA PRADESH,23,B0101,Rural,Underperformance,0.198968789,367086,699331,1066417,209149,299728,508877,362485,370213,732698,123728,121796,245524,0.618517572,1644074,1671007,3315081,158870,222059,380929,1,3,2497373,554,2862347,5359720
Not considered,Below average state,MANIPUR,15-19,0,UP,MANIPUR,14,B0101,Rural,Underperformance,0.137472482,13300,15987,29287,7164,6937,14101,10079,8463,18542,4783,4285,9068,0.732926835,76971,79171,156142,18200,19913,38113,1,3,105133,551,107906,213039
Not considered,Below average state,NAGALAND,15-19,0,UP,NAGALAND,13,B0101,Rural,Underperformance,0.197133258,14919,17002,31921,5835,6833,12668,9622,9957,19579,11278,11798,23076,0.539443944,42748,44602,87350,6940,7508,14448,1,3,78567,567,83359,161926
Not considered,Below average state,ODISHA,15-19,0,UP,ODISHA,21,B0101,Rural,Underperformance,0.117151224,104852,274738,379590,205458,266217,471675,273520,294526,568046,86817,80393,167210,0.655929888,1157993,967332,2125325,270270,317878,588148,1,3,1623182,558,1616989,3240171
Not considered,Below average state,PUDUCHERRY,15-19,0,UP,PUDUCHERRY,34,B0101,Rural,Underperformance,0.085187689,865,2033,2898,164,285,449,236,429,665,71,94,165,0.89041418,15453,14838,30291,1995,2271,4266,1,4,16625,493,17394,34019
Not considered,Below average state,PUNJAB,15-19,0,UP,PUNJAB,3,B0101,Rural,Underperformance,0.145196252,38486,224962,263448,21707,47381,69088,30795,57362,88157,12659,18204,30863,0.789207281,728656,703303,1431959,109938,150833,260771,1,3,810596,556,1003831,1814427
Not considered,Below average state,UTTAR PRADESH,15-19,0,UP,UTTAR PRADESH,9,B0101,Rural,Underperformance,0.111320358,364407,1614767,1979174,237262,741699,978961,518673,989841,1508514,219026,306460,525486,0.774275548,7183560,6582350,13765910,678493,1116334,1794827,1,4,8285666,507,9493418,17779084
Not considered,Below average state,UTTARAKHAND,15-19,0,UP,UTTARAKHAND,5,B0101,Rural,Underperformance,0.112546633,29252,59986,89238,15989,24891,40880,26715,28849,55564,18741,17801,36542,0.771289624,311121,300433,611554,32026,45587,77613,1,4,385829,544,407069,792898
Not considered,Below average state,ASSAM,15-59,0,UP,ASSAM,18,B0101,Rural,Underperformance,0.415582592,1306380,5281946,6588326,557258,745294,1302552,1239155,1009203,2248358,274208,192522,466730,0.413153371,4933632,1616183,6549815,1199211,672861,1872072,1,4,7753375,516,8099854,15853229
Not considered,Below average state,CHANDIGARH,15-59,0,UP,CHANDIGARH,4,B0101,Rural,Underperformance,0.58393446,1268,10065,11333,69,94,163,244,181,425,90,82,172,0.385305029,5875,1603,7478,579,323,902,1,4,7477,538,11931,19408
Not considered,Below average state,DADRA & NAGAR HAVELI,15-59,0,UP,DADRA & NAGAR HAVELI,26,B0101,Rural,Underperformance,0.532771646,12954,45791,58745,2146,2113,4259,11344,5631,16975,1638,1209,2847,0.287458168,22653,9043,31696,2199,1229,3428,1,4,48589,523,61674,110263
Not considered,Below average state,DELHI,15-59,0,UP,DELHI,7,B0101,Rural,Underperformance,0.42408895,13949,97921,111870,1301,4379,5680,2888,5897,8785,546,1349,1895,0.535424146,104482,36757,141239,10181,9406,19587,1,4,121865,500,141924,263789
Not considered,Below average state,GOA,15-59,0,UP,GOA,30,B0101,Rural,Underperformance,0.413959039,38478,113096,151574,8430,14970,23400,13350,21640,34990,4665,6000,10665,0.461354009,124699,44229,168928,32152,17361,49513,1,4,181192,535,184965,366157
Not considered,Below average state,JAMMU & KASHMIR,15-59,0,UP,JAMMU & KASHMIR,1,B0101,Rural,Underperformance,0.295647629,196162,1318638,1514800,223942,425894,649836,399158,490739,889897,204492,152709,357201,0.460952868,1660122,701647,2361769,396874,252982,649856,1,4,2459934,524,2663733,5123667
Not considered,Below average state,JHARKHAND,15-59,0,UP,JHARKHAND,20,B0101,Rural,Underperformance,0.319659603,1184520,3175216,4359736,1177994,1810341,2988335,1979415,2118443,4097858,616213,378681,994894,0.306935428,2884130,1302065,4186195,452232,326800,779032,1,4,6664278,529,6974405,13638683
Not considered,Below average state,KERALA,15-59,0,UP,KERALA,32,B0101,Rural,Underperformance,0.401470766,1096440,3368864,4465304,283628,364539,648167,433641,553814,987455,146955,106478,253433,0.486962304,4140056,1276116,5416172,1388050,557644,1945694,1,4,5817092,539,5305272,11122364
Not considered,Below average state,LAKSHADWEEP,15-59,0,UP,LAKSHADWEEP,31,B0101,Rural,Underperformance,0.238481181,340,1808,2148,470,1673,2143,365,1462,1827,140,336,476,0.5058288,3494,1062,4556,1783,662,2445,1,4,4339,528,4668,9007
Not considered,Below average state,MADHYA PRADESH,15-59,0,UP,MADHYA PRADESH,23,B0101,Rural,Underperformance,0.500786285,4703759,10181271,14885030,1755627,1929907,3685534,3455198,2368501,5823699,685872,415988,1101860,0.266212843,5394874,2517855,7912729,600459,481544,1082003,1,3,14239703,554,15483615,29723318
Not considered,Below average state,MANIPUR,15-59,0,UP,MANIPUR,14,B0101,Rural,Underperformance,0.508263122,242739,393457,636196,53525,41706,95231,106891,59785,166676,27603,14994,42597,0.324546659,245174,161063,406237,64143,54236,118379,1,3,622407,551,629299,1251706
Not considered,Below average state,NAGALAND,15-59,0,UP,NAGALAND,13,B0101,Rural,Underperformance,0.610680205,222964,279591,502555,24665,25072,49737,52470,36803,89273,24390,22109,46499,0.224336315,102250,82366,184616,22857,22034,44891,1,3,402074,567,420869,822943
Not considered,Below average state,ODISHA,15-59,0,UP,ODISHA,21,B0101,Rural,Underperformance,0.364336511,1428339,6258867,7687206,1535215,1772689,3307904,2593688,2126602,4720290,609883,370842,980725,0.365462858,5907390,1803581,7710971,1147360,772399,1919759,1,3,10539300,558,10559892,21099192
Not considered,Below average state,PUDUCHERRY,15-59,0,UP,PUDUCHERRY,34,B0101,Rural,Underperformance,0.439086874,28949,84515,113464,3364,5473,8837,7491,10479,17970,2501,2553,5054,0.471814062,91943,29978,121921,13188,8004,21192,1,4,130884,493,127525,258409
Not considered,Below average state,PUNJAB,15-59,0,UP,PUNJAB,3,B0101,Rural,Underperformance,0.412991349,606392,3866161,4472553,168760,293087,461847,310864,393496,704360,115579,97155,212734,0.502325051,4192387,1247619,5440006,555258,336717,891975,1,3,5225222,556,5604431,10829653
Not considered,Below average state,UTTAR PRADESH,15-59,0,UP,UTTAR PRADESH,9,B0101,Rural,Underperformance,0.336288698,4757465,23492723,28250188,1982831,5290773,7273604,5012862,7221699,12234561,1553780,1589710,3143490,0.480651821,29137962,11239560,40377522,2719056,2580765,5299821,1,4,40462069,507,43543692,84005761
Not considered,Below average state,UTTARAKHAND,15-59,0,UP,UTTARAKHAND,5,B0101,Rural,Underperformance,0.430953426,591669,1161094,1752763,141956,215576,357532,304184,257835,562019,98212,70087,168299,0.389482626,1081187,502907,1584094,125034,120604,245638,1,4,2075252,544,1991923,4067175
Not considered,Below average state,ASSAM,20-24,0,UP,ASSAM,18,B0101,Rural,Underperformance,0.293507071,157886,569308,727194,114400,178522,292922,202298,216214,418512,47713,42452,90165,0.501182796,866595,375137,1241732,294925,209875,504800,1,4,1274492,516,1203111,2477603
Not considered,Below average state,CHANDIGARH,20-24,0,UP,CHANDIGARH,4,B0101,Rural,Underperformance,0.538825494,151,1785,1936,15,29,44,36,49,85,19,23,42,0.425827999,1132,398,1530,154,133,287,1,4,1338,538,2255,3593
Not considered,Below average state,DADRA & NAGAR HAVELI,20-24,0,UP,DADRA & NAGAR HAVELI,26,B0101,Rural,Underperformance,0.529500274,2283,9330,11613,466,532,998,2085,1438,3523,286,266,552,0.284698158,4212,2032,6244,564,466,1030,1,4,8866,523,13066,21932
Not considered,Below average state,DELHI,20-24,0,UP,DELHI,7,B0101,Rural,Underperformance,0.311009526,1442,12369,13811,229,907,1136,426,1086,1512,73,296,369,0.646632288,18661,10054,28715,3138,3982,7120,1,4,20602,500,23805,44407
Not considered,Below average state,GOA,20-24,0,UP,GOA,30,B0101,Rural,Underperformance,0.363417213,5772,11414,17186,1704,2672,4376,1962,3047,5009,590,891,1481,0.49934447,14376,9238,23614,6811,5253,12064,1,4,22700,535,24590,47290
Not considered,Below average state,JAMMU & KASHMIR,20-24,0,UP,JAMMU & KASHMIR,1,B0101,Rural,Underperformance,0.194913708,25713,135551,161264,45542,78895,124437,62873,79802,142675,32860,28314,61174,0.558701703,282623,179625,462248,100299,87841,188140,1,4,404069,524,423292,827361
Not considered,Below average state,JHARKHAND,20-24,0,UP,JHARKHAND,20,B0101,Rural,Underperformance,0.250604821,156146,358160,514306,195877,297097,492974,304100,325062,629162,98600,66773,165373,0.362243752,462329,281089,743418,99868,105655,205523,1,4,1021175,529,1031084,2052259
Not considered,Below average state,KERALA,20-24,0,UP,KERALA,32,B0101,Rural,Underperformance,0.255165537,70860,282815,353675,32944,66498,99442,34637,70763,105400,8414,16274,24688,0.650980007,591867,310431,902298,328891,210751,539642,1,4,705778,539,680283,1386061
Not considered,Below average state,LAKSHADWEEP,20-24,0,UP,LAKSHADWEEP,31,B0101,Rural,Underperformance,0.08125,13,91,104,75,306,381,56,243,299,22,75,97,0.609375,509,271,780,412,231,643,1,4,600,528,680,1280
Not considered,Below average state,MADHYA PRADESH,20-24,0,UP,MADHYA PRADESH,23,B0101,Rural,Underperformance,0.437165283,637618,1407773,2045391,301170,412392,713562,544749,481722,1026471,116393,88097,204490,0.299739097,898371,504036,1402407,145376,161271,306647,1,3,2197131,554,2481628,4678759
Not considered,Below average state,MANIPUR,20-24,0,UP,MANIPUR,14,B0101,Rural,Underperformance,0.359999805,30428,43278,73706,11220,10213,21433,17130,12212,29342,5349,3682,9031,0.452576207,49609,43051,92660,17955,18468,36423,1,3,102516,551,102223,204739
Not considered,Below average state,NAGALAND,20-24,0,UP,NAGALAND,13,B0101,Rural,Underperformance,0.451049928,28968,33990,62958,7062,7917,14979,10237,9499,19736,5729,5714,11443,0.325574398,23703,21741,45444,7753,8125,15878,1,3,68637,567,70944,139581
Not considered,Below average state,ODISHA,20-24,0,UP,ODISHA,21,B0101,Rural,Underperformance,0.258068361,166633,627920,794553,250785,357779,608564,369266,393187,762453,90819,74544,165363,0.440579866,938466,418012,1356478,275488,253213,528701,1,3,1565184,558,1513663,3078847
Not considered,Below average state,PUDUCHERRY,20-24,0,UP,PUDUCHERRY,34,B0101,Rural,Underperformance,0.292098588,3002,7593,10595,486,874,1360,666,1176,1842,205,299,504,0.643223423,15244,8087,23331,3726,3265,6991,1,4,19117,493,17155,36272
Not considered,Below average state,PUNJAB,20-24,0,UP,PUNJAB,3,B0101,Rural,Underperformance,0.347783878,75039,518570,593609,30154,66671,96825,45790,80202,125992,16654,20428,37082,0.556674262,680611,269539,950150,142195,112486,254681,1,3,818094,556,888739,1706833
Not considered,Below average state,UTTAR PRADESH,20-24,0,UP,UTTAR PRADESH,9,B0101,Rural,Underperformance,0.2704266,542754,2969829,3512583,295097,996876,1291973,670066,1256922,1926988,211774,281885,493659,0.543212726,4636749,2419065,7055814,588806,782519,1371325,1,4,6061343,507,6927701,12989044
Not considered,Below average state,UTTARAKHAND,20-24,0,UP,UTTARAKHAND,5,B0101,Rural,Underperformance,0.33788407,79033,139925,218958,29317,42331,71648,48309,43901,92210,16372,13654,30026,0.473487987,191882,114951,306833,37169,45108,82277,1,4,335596,544,312431,648027
Not considered,Below average state,ASSAM,25-29,0,UP,ASSAM,18,B0101,Rural,Underperformance,0.419880914,201994,800056,1002050,110872,146463,257335,217498,186512,404010,45594,31236,76830,0.378636586,738361,165259,903620,224845,101399,326244,1,4,1203447,516,1183063,2386510
Not considered,Below average state,CHANDIGARH,25-29,0,UP,CHANDIGARH,4,B0101,Rural,Underperformance,0.617446138,215,2135,2350,15,17,32,52,24,76,14,11,25,0.356016816,1265,90,1355,169,43,212,1,4,1546,538,2260,3806
Not considered,Below average state,DADRA & NAGAR HAVELI,25-29,0,UP,DADRA & NAGAR HAVELI,26,B0101,Rural,Underperformance,0.596590587,1948,8586,10534,329,431,760,1798,1004,2802,228,190,418,0.221045478,3428,475,3903,390,150,540,1,4,7402,523,10255,17657
Not considered,Below average state,DELHI,25-29,0,UP,DELHI,7,B0101,Rural,Underperformance,0.475541401,2044,16621,18665,231,851,1082,466,1084,1550,87,239,326,0.47666242,16069,2640,18709,2197,1561,3758,1,4,18666,500,20584,39250
Not considered,Below average state,GOA,25-29,0,UP,GOA,30,B0101,Rural,Underperformance,0.470721398,6749,16748,23497,1542,2796,4338,1994,3448,5442,573,864,1437,0.39146984,15351,4190,19541,6203,2763,8966,1,4,24667,535,25250,49917
Not considered,Below average state,JAMMU & KASHMIR,25-29,0,UP,JAMMU & KASHMIR,1,B0101,Rural,Underperformance,0.340583399,33113,218431,251544,40668,73967,114635,64693,80414,145107,31738,22565,54303,0.38942115,223480,64134,287614,70164,36202,106366,1,4,353024,524,385544,738568
Not considered,Below average state,JHARKHAND,25-29,0,UP,JHARKHAND,20,B0101,Rural,Underperformance,0.340070088,178489,482073,660562,195229,307308,502537,312858,347769,660627,95016,54511,149527,0.242846971,379172,92541,471713,75570,42038,117608,1,4,965535,529,976894,1942429
Not considered,Below average state,KERALA,25-29,0,UP,KERALA,32,B0101,Rural,Underperformance,0.413938713,115184,451513,566697,41765,68519,110284,46406,81187,127593,13622,15095,28717,0.471886057,554785,91244,646029,282812,67450,350262,1,4,729997,539,639039,1369036
Not considered,Below average state,LAKSHADWEEP,25-29,0,UP,LAKSHADWEEP,31,B0101,Rural,Underperformance,0.183141762,52,187,239,116,363,479,87,304,391,33,68,101,0.439846743,451,123,574,336,116,452,1,4,623,528,682,1305
Not considered,Below average state,MADHYA PRADESH,25-29,0,UP,MADHYA PRADESH,23,B0101,Rural,Underperformance,0.546001136,670645,1508368,2179013,271794,315089,586883,517702,376723,894425,95616,53343,148959,0.192555335,639441,129020,768461,89486,50370,139856,1,3,1923404,554,2067454,3990858
Not considered,Below average state,MANIPUR,25-29,0,UP,MANIPUR,14,B0101,Rural,Underperformance,0.529321764,38293,61689,99982,10839,8397,19236,18796,11000,29796,4754,2302,7056,0.275577462,33418,18635,52053,11718,9065,20783,1,3,95261,551,93626,188887
Not considered,Below average state,NAGALAND,25-29,0,UP,NAGALAND,13,B0101,Rural,Underperformance,0.649605997,34564,41525,76089,5040,5077,10117,8851,6359,15210,2848,2413,5261,0.175623874,12280,8291,20571,4370,4140,8510,1,3,58543,567,58588,117131
Not considered,Below average state,ODISHA,25-29,0,UP,ODISHA,21,B0101,Rural,Underperformance,0.367434969,195988,876551,1072539,236169,303598,539767,373105,346058,719163,84143,53752,137895,0.338950459,819370,170023,989393,197889,112601,310490,1,3,1472606,558,1446384,2918990
Not considered,Below average state,PUDUCHERRY,25-29,0,UP,PUDUCHERRY,34,B0101,Rural,Underperformance,0.457595263,4173,13600,17773,607,1093,1700,1050,1645,2695,327,385,712,0.454685891,14848,2812,17660,3221,1540,4761,1,4,20398,493,18442,38840
Not considered,Below average state,PUNJAB,25-29,0,UP,PUNJAB,3,B0101,Rural,Underperformance,0.459322027,89157,579366,668523,25995,48120,74115,44347,62464,106811,16245,14507,30752,0.446162577,567511,81859,649370,98950,35413,134363,1,3,717260,556,738196,1455456
Not considered,Below average state,UTTAR PRADESH,25-29,0,UP,UTTAR PRADESH,9,B0101,Rural,Underperformance,0.368161198,649513,3348986,3998499,300864,863426,1164290,717723,1130040,1847763,216149,228776,444925,0.420739897,3745892,823650,4569542,412748,301705,714453,1,4,5329277,507,5531452,10860729
Not considered,Below average state,UTTARAKHAND,25-29,0,UP,UTTARAKHAND,5,B0101,Rural,Underperformance,0.492003836,87572,173069,260641,24109,36747,60856,45356,40383,85739,12668,9157,21825,0.304950977,130881,30668,161549,21713,15613,37326,1,4,276477,544,253277,529754
Not considered,Below average state,ASSAM,30-34,0,UP,ASSAM,18,B0101,Rural,Underperformance,0.491415792,192617,765403,958020,80295,93536,173831,178027,124710,302737,35714,19869,55583,0.324784177,558532,74638,633170,143874,42996,186870,1,4,964890,516,984620,1949510
Not considered,Below average state,CHANDIGARH,30-34,0,UP,CHANDIGARH,4,B0101,Rural,Underperformance,0.682038052,284,1831,2115,10,12,22,35,28,63,20,7,27,0.288939052,860,36,896,98,16,114,1,4,1199,538,1902,3101
Not considered,Below average state,DADRA & NAGAR HAVELI,30-34,0,UP,DADRA & NAGAR HAVELI,26,B0101,Rural,Underperformance,0.618015267,1650,6446,8096,270,212,482,1490,603,2093,178,113,291,0.2,2460,160,2620,242,35,277,1,4,5778,523,7322,13100
Not considered,Below average state,DELHI,30-34,0,UP,DELHI,7,B0101,Rural,Underperformance,0.524724382,2291,15462,17753,207,648,855,435,880,1315,80,183,263,0.428634765,13596,906,14502,1374,479,1853,1,4,16402,500,17431,33833
Not considered,Below average state,GOA,30-34,0,UP,GOA,30,B0101,Rural,Underperformance,0.476649262,5399,17606,23005,1186,2313,3499,1757,3171,4928,598,768,1366,0.39294298,16300,2665,18965,5128,1649,6777,1,4,24054,535,24210,48264
Not considered,Below average state,JAMMU & KASHMIR,30-34,0,UP,JAMMU & KASHMIR,1,B0101,Rural,Underperformance,0.394179241,32776,217976,250752,32173,62599,94772,57449,70959,128408,27917,18509,46426,0.330983735,184933,25618,210551,45666,12951,58617,1,4,303075,524,333062,636137
Not considered,Below average state,JHARKHAND,30-34,0,UP,JHARKHAND,20,B0101,Rural,Underperformance,0.379921062,173357,471472,644829,172989,259909,432898,283955,297535,581490,81961,42268,124229,0.20428264,308705,38018,346723,55006,16011,71017,1,4,847978,529,849293,1697271
Not considered,Below average state,KERALA,30-34,0,UP,KERALA,32,B0101,Rural,Underperformance,0.479721653,141553,471656,613209,44887,51985,96872,55834,70606,126440,19226,11981,31207,0.396948978,468673,38731,507404,199004,23108,222112,1,4,685286,539,592974,1278260
Not considered,Below average state,LAKSHADWEEP,30-34,0,UP,LAKSHADWEEP,31,B0101,Rural,Underperformance,0.253441296,59,254,313,97,315,412,72,265,337,31,69,100,0.392712551,431,54,485,275,47,322,1,4,593,528,642,1235
Not considered,Below average state,MADHYA PRADESH,30-34,0,UP,MADHYA PRADESH,23,B0101,Rural,Underperformance,0.587651063,686899,1451545,2138444,253539,246125,499664,494082,296962,791044,85338,38652,123990,0.160894748,531143,54348,585491,63599,17806,81405,1,3,1797462,554,1841507,3638969
Not considered,Below average state,MANIPUR,30-34,0,UP,MANIPUR,14,B0101,Rural,Underperformance,0.618751728,34809,59193,94002,7401,5441,12842,15035,7844,22879,3301,1388,4689,0.199786733,22634,7718,30352,6283,3639,9922,1,3,75779,551,76143,151922
Not considered,Below average state,NAGALAND,30-34,0,UP,NAGALAND,13,B0101,Rural,Underperformance,0.761752179,33541,43009,76550,2806,2559,5365,7018,3793,10811,1574,974,2548,0.105311866,7577,3006,10583,1972,1398,3370,1,3,49710,567,50782,100492
Not considered,Below average state,ODISHA,30-34,0,UP,ODISHA,21,B0101,Rural,Underperformance,0.431089494,198376,888051,1086427,205729,216619,422348,344525,255297,599822,74781,37093,111874,0.286512639,655304,66762,722066,130044,39549,169593,1,3,1272986,558,1247203,2520189
Not considered,Below average state,PUDUCHERRY,30-34,0,UP,PUDUCHERRY,34,B0101,Rural,Underperformance,0.538136835,4411,13947,18358,561,902,1463,1099,1564,2663,360,355,715,0.362842235,11376,1002,12378,1791,425,2216,1,4,17246,493,16868,34114
Not considered,Below average state,PUNJAB,30-34,0,UP,PUNJAB,3,B0101,Rural,Underperformance,0.495740424,88488,537883,626371,23472,34645,58117,43143,47604,90747,16139,10712,26851,0.411186809,479468,40069,519537,61631,12610,74241,1,3,627238,556,636268,1263506
Not considered,Below average state,UTTAR PRADESH,30-34,0,UP,UTTAR PRADESH,9,B0101,Rural,Underperformance,0.402095266,689610,3255105,3944715,294670,714935,1009605,727900,955222,1683122,214886,187779,402665,0.38529493,3352942,426955,3779897,314909,144602,459511,1,4,4985338,507,4825061,9810399
Not considered,Below average state,UTTARAKHAND,30-34,0,UP,UTTARAKHAND,5,B0101,Rural,Underperformance,0.549536541,82859,169464,252323,18930,29569,48499,39307,33926,73233,10367,6802,17169,0.253576127,104733,11698,116431,12326,5457,17783,1,4,237266,544,221890,459156
Not considered,Below average state,ASSAM,35-39,0,UP,ASSAM,18,B0101,Rural,Underperformance,0.534458553,202510,802139,1004649,70082,71830,141912,169452,100853,270305,33389,15977,49366,0.295481157,512370,43061,555431,114767,21818,136585,1,4,917721,516,962030,1879751
Not considered,Below average state,CHANDIGARH,35-39,0,UP,CHANDIGARH,4,B0101,Rural,Underperformance,0.695820767,201,1414,1615,9,5,14,38,14,52,12,6,18,0.274019819,615,21,636,60,9,69,1,4,866,538,1455,2321
Not considered,Below average state,DADRA & NAGAR HAVELI,35-39,0,UP,DADRA & NAGAR HAVELI,26,B0101,Rural,Underperformance,0.622923588,1610,5515,7125,219,177,396,1388,480,1868,159,86,245,0.192341318,2072,128,2200,191,29,220,1,4,5229,523,6209,11438
Not considered,Below average state,DELHI,35-39,0,UP,DELHI,7,B0101,Rural,Underperformance,0.558866279,2382,15305,17687,211,558,769,461,757,1218,96,169,265,0.39427452,11971,507,12478,943,220,1163,1,4,14910,500,16738,31648
Not considered,Below average state,GOA,35-39,0,UP,GOA,30,B0101,Rural,Underperformance,0.483507626,5232,18163,23395,1220,2261,3481,1916,3156,5072,671,775,1446,0.381783987,16299,2174,18473,4235,1176,5411,1,4,24118,535,24268,48386
Not considered,Below average state,JAMMU & KASHMIR,35-39,0,UP,JAMMU & KASHMIR,1,B0101,Rural,Underperformance,0.406736694,30257,201105,231362,26940,53690,80630,52615,63180,115795,25070,16085,41155,0.317343647,166615,13898,180513,35005,5826,40831,1,4,274557,524,294268,568825
Not considered,Below average state,JHARKHAND,35-39,0,UP,JHARKHAND,20,B0101,Rural,Underperformance,0.405355765,168954,467761,636715,156308,233483,389791,261172,272108,533280,73292,37137,110429,0.184835837,267388,22944,290332,43800,8387,52187,1,4,770806,529,799950,1570756
Not considered,Below average state,KERALA,35-39,0,UP,KERALA,32,B0101,Rural,Underperformance,0.515379335,195144,497850,692994,53255,47327,100582,73490,69878,143368,25735,11769,37504,0.350106237,441919,28844,470763,157126,14154,171280,1,4,736288,539,608341,1344629
Not considered,Below average state,LAKSHADWEEP,35-39,0,UP,LAKSHADWEEP,31,B0101,Rural,Underperformance,0.27688172,55,254,309,85,273,358,72,236,308,23,50,73,0.38172043,376,50,426,214,42,256,1,4,526,528,590,1116
Not considered,Below average state,MADHYA PRADESH,35-39,0,UP,MADHYA PRADESH,23,B0101,Rural,Underperformance,0.612719425,670875,1417032,2087907,229602,214269,443871,456010,262481,718491,75758,33758,109516,0.144292754,454495,37198,491693,48620,9958,58578,1,3,1657138,554,1750469,3407607
Not considered,Below average state,MANIPUR,35-39,0,UP,MANIPUR,14,B0101,Rural,Underperformance,0.662562212,33230,56630,89860,6007,3866,9873,13751,6118,19869,2764,1039,3803,0.162897696,18241,3852,22093,4235,1557,5792,1,3,67986,551,67639,135625
Not considered,Below average state,NAGALAND,35-39,0,UP,NAGALAND,13,B0101,Rural,Underperformance,0.811850407,31947,38822,70769,1819,1205,3024,5614,2416,8030,1094,470,1564,0.078088792,5448,1359,6807,979,472,1451,1,3,44103,567,43067,87170
Not considered,Below average state,ODISHA,35-39,0,UP,ODISHA,21,B0101,Rural,Underperformance,0.463005615,215281,936395,1151676,202645,194717,397362,352084,235274,587358,74260,33357,107617,0.257595207,603174,37566,640740,102375,17652,120027,1,3,1244799,558,1242592,2487391
Not considered,Below average state,PUDUCHERRY,35-39,0,UP,PUDUCHERRY,34,B0101,Rural,Underperformance,0.569841559,5110,13664,18774,590,816,1406,1332,1562,2894,422,363,785,0.318490864,9892,601,10493,1135,181,1316,1,4,16756,493,16190,32946
Not considered,Below average state,PUNJAB,35-39,0,UP,PUNJAB,3,B0101,Rural,Underperformance,0.509798461,90751,522456,613207,22476,29911,52387,43060,42258,85318,16140,9302,25442,0.39811962,448642,30233,478875,49954,7523,57477,1,3,598593,556,604249,1202842
Not considered,Below average state,UTTAR PRADESH,35-39,0,UP,UTTAR PRADESH,9,B0101,Rural,Underperformance,0.437999681,717001,3454377,4171378,280014,667745,947759,713018,913556,1626574,206129,178528,384657,0.350818658,3039345,301747,3341092,260895,91447,352342,1,4,4675493,507,4848208,9523701
Not considered,Below average state,UTTARAKHAND,35-39,0,UP,UTTARAKHAND,5,B0101,Rural,Underperformance,0.57511986,84176,169652,253828,16944,26805,43749,37931,32029,69960,9967,6156,16123,0.229834507,94032,7405,101437,8810,2676,11486,1,4,226106,544,215242,441348
Not considered,Below average state,ASSAM,40-49,0,UP,ASSAM,18,B0101,Rural,Underperformance,0.567051169,311878,1286079,1597957,76539,78075,154614,232012,128415,360427,46522,20965,67487,0.281099229,740597,51544,792141,112544,17556,130100,1,4,1331009,516,1487003,2818012
Not considered,Below average state,CHANDIGARH,40-49,0,UP,CHANDIGARH,4,B0101,Rural,Underperformance,0.679506934,245,1519,1764,11,0,11,37,11,48,14,8,22,0.293528505,715,47,762,36,8,44,1,4,1011,538,1585,2596
Not considered,Below average state,DADRA & NAGAR HAVELI,40-49,0,UP,DADRA & NAGAR HAVELI,26,B0101,Rural,Underperformance,0.601489758,2461,7875,10336,318,270,588,2227,747,2974,283,135,418,0.201117318,3216,240,3456,230,38,268,1,4,8187,523,8997,17184
Not considered,Below average state,DELHI,40-49,0,UP,DELHI,7,B0101,Rural,Underperformance,0.582431307,3597,22984,26581,228,739,967,638,1097,1735,105,211,316,0.372628073,16137,869,17006,810,255,1065,1,4,20477,500,25161,45638
Not considered,Below average state,GOA,40-49,0,UP,GOA,30,B0101,Rural,Underperformance,0.48684678,8362,28633,36995,1538,2931,4469,3050,4882,7932,1202,1394,2596,0.374606851,25019,3447,28466,3903,1320,5223,1,4,37633,535,38356,75989
Not considered,Below average state,JAMMU & KASHMIR,40-49,0,UP,JAMMU & KASHMIR,1,B0101,Rural,Underperformance,0.411658123,41743,320179,361922,33762,74119,107881,78430,94402,172832,38395,24772,63167,0.319911372,258589,22671,281260,40366,6895,47261,1,4,417157,524,462024,879181
Not considered,Below average state,JHARKHAND,40-49,0,UP,JHARKHAND,20,B0101,Rural,Underperformance,0.419856425,264755,757346,1022101,222711,339074,561785,398165,412065,810230,110278,56116,166394,0.178968093,404081,31600,435681,53351,9071,62422,1,4,1177279,529,1257127,2434406
Not considered,Below average state,KERALA,40-49,0,UP,KERALA,32,B0101,Rural,Underperformance,0.522913719,356862,936837,1293699,71335,71750,143085,131619,133121,264740,47418,23367,70785,0.341466924,781467,63329,844796,162034,20771,182805,1,4,1317366,539,1156654,2474020
Not considered,Below average state,LAKSHADWEEP,40-49,0,UP,LAKSHADWEEP,31,B0101,Rural,Underperformance,0.375446961,91,539,630,68,277,345,55,265,320,16,47,63,0.396305125,633,32,665,243,23,266,1,4,795,528,883,1678
Not considered,Below average state,MADHYA PRADESH,40-49,0,UP,MADHYA PRADESH,23,B0101,Rural,Underperformance,0.629292559,1068271,2306479,3374750,330271,296212,626483,692474,375055,1067529,114189,49277,163466,0.141162735,699696,57327,757023,62421,12158,74579,1,3,2574630,554,2788138,5362768
Not considered,Below average state,MANIPUR,40-49,0,UP,MANIPUR,14,B0101,Rural,Underperformance,0.702477589,57224,95430,152654,7128,4553,11681,20082,8619,28701,3984,1364,5348,0.140836969,25916,4689,30605,3918,1120,5038,1,3,107206,551,110102,217308
Not considered,Below average state,NAGALAND,40-49,0,UP,NAGALAND,13,B0101,Rural,Underperformance,0.854470278,50538,66844,117382,1501,1091,2592,7272,2985,10257,1189,444,1633,0.058977681,6520,1582,8102,628,296,924,1,3,65519,567,71855,137374
Not considered,Below average state,ODISHA,40-49,0,UP,ODISHA,21,B0101,Rural,Underperformance,0.482388944,354395,1624322,1978717,293548,286220,579768,558198,372418,930616,119115,53612,172727,0.248628444,961083,58769,1019852,116621,19186,135807,1,3,1992791,558,2109121,4101912
Not considered,Below average state,PUDUCHERRY,40-49,0,UP,PUDUCHERRY,34,B0101,Rural,Underperformance,0.577380358,7438,21457,28895,694,1031,1725,2018,2508,4526,698,633,1331,0.305584974,14311,982,15293,976,194,1170,1,4,24465,493,25580,50045
Not considered,Below average state,PUNJAB,40-49,0,UP,PUNJAB,3,B0101,Rural,Underperformance,0.513530755,147435,914334,1061769,31359,44235,75594,68309,66273,134582,24878,14767,39645,0.402203342,775475,56115,831590,64376,10819,75195,1,3,1016097,556,1051489,2067586
Not considered,Below average state,UTTAR PRADESH,40-49,0,UP,UTTAR PRADESH,9,B0101,Rural,Underperformance,0.464964297,1089624,5402911,6492535,372904,868778,1241682,1027284,1259059,2286343,294277,250595,544872,0.33227763,4257441,382322,4639763,305399,94695,400094,1,4,6668626,507,7294887,13963513
Not considered,Below average state,UTTARAKHAND,40-49,0,UP,UTTARAKHAND,5,B0101,Rural,Underperformance,0.583857544,136867,274491,411358,23662,36786,60448,62170,48128,110298,16318,9647,25965,0.222738705,141182,15749,156931,8811,3767,12578,1,4,356537,544,348015,704552
Not considered,Below average state,ASSAM,5-Sep,0,UP,ASSAM,18,B0101,Rural,Underperformance,0.005306786,7186,9749,16935,4433,5134,9567,12892,13318,26210,4872,5069,9941,0.983364863,1541629,1596482,3138111,16812,17710,34522,1,4,1566579,516,1624618,3191197
Not considered,Below average state,CHANDIGARH,5-Sep,0,UP,CHANDIGARH,4,B0101,Rural,Underperformance,0.005135228,3,12,15,1,1,2,2,2,4,0,2,2,0.992810681,1344,1556,2900,4,5,9,1,4,1349,538,1572,2921
Not considered,Below average state,DADRA & NAGAR HAVELI,5-Sep,0,UP,DADRA & NAGAR HAVELI,26,B0101,Rural,Underperformance,0.003184411,35,32,67,9,11,20,34,37,71,9,6,15,0.992728137,10168,10719,20887,40,55,95,1,4,10246,523,10794,21040
Not considered,Below average state,DELHI,5-Sep,0,UP,DELHI,7,B0101,Rural,Underperformance,0.00392074,60,107,167,6,8,14,28,31,59,1,8,9,0.994482791,18807,23552,42359,62,98,160,1,4,18896,500,23698,42594
Not considered,Below average state,GOA,5-Sep,0,UP,GOA,30,B0101,Rural,Underperformance,0.029087491,559,586,1145,54,42,96,121,116,237,8,8,16,0.964485317,18511,19455,37966,287,290,577,1,4,19199,535,20165,39364
Not considered,Below average state,JAMMU & KASHMIR,5-Sep,0,UP,JAMMU & KASHMIR,1,B0101,Rural,Underperformance,0.005056553,2384,3224,5608,2230,2527,4757,5259,5557,10816,3259,3362,6621,0.979221067,513160,572851,1086011,8854,10169,19023,1,4,524062,524,584994,1109056
Not considered,Below average state,JHARKHAND,5-Sep,0,UP,JHARKHAND,20,B0101,Rural,Underperformance,0.005958589,9120,10738,19858,4009,4471,8480,16031,15684,31715,14549,13779,28328,0.976024915,1597387,1655380,3252767,11678,12510,24188,1,4,1637087,529,1695581,3332668
Not considered,Below average state,KERALA,5-Sep,0,UP,KERALA,32,B0101,Rural,Underperformance,0.002853426,1695,2152,3847,928,1021,1949,1984,2068,4052,146,169,315,0.99390745,657302,682688,1339990,11006,11428,22434,1,4,661127,539,687077,1348204
Not considered,Below average state,LAKSHADWEEP,5-Sep,0,UP,LAKSHADWEEP,31,B0101,Rural,Underperformance,0,0,0,0,1,0,1,3,0,3,0,0,0,0.99783237,653,728,1381,9,6,15,1,4,656,528,728,1384
Not considered,Below average state,MADHYA PRADESH,5-Sep,0,UP,MADHYA PRADESH,23,B0101,Rural,Underperformance,0.007170455,21080,24435,45515,4722,5040,9762,19234,19150,38384,13806,13382,27188,0.982499301,3001212,3235276,6236488,17924,19681,37605,1,3,3055332,554,3292243,6347575
Not considered,Below average state,MANIPUR,5-Sep,0,UP,MANIPUR,14,B0101,Rural,Underperformance,0.013174264,1308,1530,2838,982,1092,2074,2112,2273,4385,776,836,1612,0.958987095,100112,106473,206585,2631,2808,5439,1,3,104308,551,111112,215420
Not considered,Below average state,NAGALAND,5-Sep,0,UP,NAGALAND,13,B0101,Rural,Underperformance,0.010061973,836,911,1747,477,528,1005,1636,1725,3361,3809,3953,7762,0.925874303,77223,83531,160754,1479,1630,3109,1,3,83504,567,90120,173624
Not considered,Below average state,ODISHA,5-Sep,0,UP,ODISHA,21,B0101,Rural,Underperformance,0.004723684,7511,8998,16509,4263,4150,8413,12446,11487,23933,6666,6168,12834,0.984756256,1685803,1755863,3441666,13674,14641,28315,1,3,1712426,558,1782516,3494942
Not considered,Below average state,PUDUCHERRY,5-Sep,0,UP,PUDUCHERRY,34,B0101,Rural,Underperformance,0.00545984,83,97,180,8,19,27,36,49,85,3,3,6,0.991779908,16036,16661,32697,69,82,151,1,4,16158,493,16810,32968
Not considered,Below average state,PUNJAB,5-Sep,0,UP,PUNJAB,3,B0101,Rural,Underperformance,0.009427201,5461,8746,14207,1942,2525,4467,5664,6979,12643,661,759,1420,0.98124115,667331,811421,1478752,6548,8388,14936,1,3,679117,556,827905,1507022
Not considered,Below average state,UTTAR PRADESH,5-Sep,0,UP,UTTAR PRADESH,9,B0101,Rural,Underperformance,0.010979569,92253,131318,223571,33734,42982,76716,112253,127378,239631,31427,34681,66108,0.974005591,9381920,10451226,19833146,77168,91558,168726,1,4,9617853,507,10744603,20362456
Not considered,Below average state,UTTARAKHAND,5-Sep,0,UP,UTTARAKHAND,5,B0101,Rural,Underperformance,0.00778762,2749,3252,6001,599,685,1284,2478,2519,4997,2702,2445,5147,0.979048304,358398,396039,754437,1937,2308,4245,1,4,366327,544,404255,770582
Not considered,Below average state,ASSAM,50-59,0,UP,ASSAM,18,B0101,Rural,Underperformance,0.548284848,160024,759862,919886,28990,31281,60271,116903,68381,185284,26155,12172,38327,0.318435025,483135,51120,534255,40211,7631,47842,1,4,786217,516,891535,1677752
Not considered,Below average state,CHANDIGARH,50-59,0,UP,CHANDIGARH,4,B0101,Rural,Underperformance,0.550570962,69,606,675,4,7,11,18,15,33,1,0,1,0.421696574,451,66,517,11,7,18,1,4,539,538,687,1226
Not considered,Below average state,DADRA & NAGAR HAVELI,50-59,0,UP,DADRA & NAGAR HAVELI,26,B0101,Rural,Underperformance,0.548546131,1304,4148,5452,125,144,269,1181,475,1656,190,131,321,0.252540497,2214,296,2510,62,19,81,1,4,4889,523,5050,9939
Not considered,Below average state,DELHI,50-59,0,UP,DELHI,7,B0101,Rural,Underperformance,0.530755498,1705,11376,13081,86,266,352,295,520,815,61,101,162,0.429603181,9296,1292,10588,216,140,356,1,4,11357,500,13289,24646
Not considered,Below average state,GOA,50-59,0,UP,GOA,30,B0101,Rural,Underperformance,0.421820541,5181,17572,22753,512,1155,1667,1819,2913,4732,761,897,1658,0.459714498,19888,4909,24797,1325,758,2083,1,4,27649,535,26291,53940
Not considered,Below average state,JAMMU & KASHMIR,50-59,0,UP,JAMMU & KASHMIR,1,B0101,Rural,Underperformance,0.376016234,20173,185691,205864,14530,37730,52260,43278,56505,99783,22345,16771,39116,0.370280938,173246,29478,202724,16259,4883,21142,1,4,259042,524,288445,547487
Not considered,Below average state,JHARKHAND,50-59,0,UP,JHARKHAND,20,B0101,Rural,Underperformance,0.396840465,158018,469861,627879,113029,179537,292566,235732,244966,480698,72721,38442,111163,0.229083646,323988,38467,362455,26705,6039,32744,1,4,790459,529,791736,1582195
Not considered,Below average state,KERALA,50-59,0,UP,KERALA,32,B0101,Rural,Underperformance,0.458279537,201015,671799,872814,28276,38015,66291,78939,105556,184495,30172,22212,52384,0.417344825,662642,132210,794852,52373,17094,69467,1,4,972768,539,931777,1904545
Not considered,Below average state,LAKSHADWEEP,50-59,0,UP,LAKSHADWEEP,31,B0101,Rural,Underperformance,0.430979133,68,469,537,20,101,121,17,117,134,9,18,27,0.439807384,486,62,548,74,32,106,1,4,580,528,666,1246
Not considered,Below average state,MADHYA PRADESH,50-59,0,UP,MADHYA PRADESH,23,B0101,Rural,Underperformance,0.606797037,602365,1390743,1993108,160102,146092,306194,387696,205345,593041,74850,31065,105915,0.180407454,527654,64919,592573,32087,7922,40009,1,3,1592565,554,1692072,3284637
Not considered,Below average state,MANIPUR,50-59,0,UP,MANIPUR,14,B0101,Rural,Underperformance,0.689833507,35455,61250,96705,3766,2299,6065,12018,5529,17547,2668,934,3602,0.159302641,18385,3947,22332,1834,474,2308,1,3,68526,551,71660,140186
Not considered,Below average state,NAGALAND,50-59,0,UP,NAGALAND,13,B0101,Rural,Underperformance,0.843785086,28487,38399,66886,602,390,992,3856,1794,5650,678,296,974,0.072651352,3974,1785,5759,215,95,310,1,3,36995,567,42274,79269
Not considered,Below average state,ODISHA,50-59,0,UP,ODISHA,21,B0101,Rural,Underperformance,0.444709655,192814,1030890,1223704,140881,147539,288420,322990,229842,552832,79948,38091,118039,0.311487259,772000,85117,857117,54673,12320,66993,1,3,1367752,558,1383940,2751692
Not considered,Below average state,PUDUCHERRY,50-59,0,UP,PUDUCHERRY,34,B0101,Rural,Underperformance,0.502626426,3950,12221,16171,262,472,734,1090,1595,2685,418,424,842,0.38774749,10819,1656,12475,344,128,472,1,4,16277,493,15896,32173
Not considered,Below average state,PUNJAB,50-59,0,UP,PUNJAB,3,B0101,Rural,Underperformance,0.489480312,77036,568590,645626,13597,22124,35721,35420,37333,72753,12864,9235,22099,0.438607797,512024,66501,578525,28214,7033,35247,1,3,637344,556,681659,1319003
Not considered,Below average state,UTTAR PRADESH,50-59,0,UP,UTTAR PRADESH,9,B0101,Rural,Underperformance,0.457227773,704556,3446748,4151304,202020,437314,639334,638198,717059,1355257,191539,155687,347226,0.355259458,2922033,303471,3225504,157806,49463,207269,1,4,4456326,507,4622965,9079291
Not considered,Below average state,UTTARAKHAND,50-59,0,UP,UTTARAKHAND,5,B0101,Rural,Underperformance,0.542115009,91910,174507,266417,13005,18447,31452,44396,30619,75015,13779,6870,20649,0.263224402,107356,22003,129359,4179,2396,6575,1,4,257441,544,233999,491440
Not considered,Below average state,ASSAM,60-69,0,UP,ASSAM,18,B0101,Rural,Underperformance,0.409301492,71061,367499,438560,10733,13355,24088,52472,41988,94460,14096,9656,23752,0.480373015,394678,120034,514712,16968,6243,23211,1,4,532307,516,539177,1071484
Not considered,Below average state,CHANDIGARH,60-69,0,UP,CHANDIGARH,4,B0101,Rural,Underperformance,0.244565217,16,164,180,0,6,6,5,17,22,2,5,7,0.716032609,296,231,527,5,13,18,1,4,319,538,417,736
Not considered,Below average state,DADRA & NAGAR HAVELI,60-69,0,UP,DADRA & NAGAR HAVELI,26,B0101,Rural,Underperformance,0.37436235,530,1745,2275,47,49,96,582,252,834,106,69,175,0.459601777,2102,691,2793,46,13,59,1,4,3320,523,2757,6077
Not considered,Below average state,DELHI,60-69,0,UP,DELHI,7,B0101,Rural,Underperformance,0.26652392,686,4044,4730,47,141,188,181,321,502,35,89,124,0.698202513,8020,4371,12391,118,140,258,1,4,8922,500,8825,17747
Not considered,Below average state,GOA,60-69,0,UP,GOA,30,B0101,Rural,Underperformance,0.187369494,1980,5737,7717,171,391,562,856,1597,2453,400,584,984,0.729179818,19043,10989,30032,473,384,857,1,4,22279,535,18907,41186
Not considered,Below average state,JAMMU & KASHMIR,60-69,0,UP,JAMMU & KASHMIR,1,B0101,Rural,Underperformance,0.246293544,8885,81437,90322,5754,19902,25656,19929,36824,56753,11281,13448,24729,0.531518168,134610,60311,194921,7483,4422,11905,1,4,174705,524,192020,366725
Not considered,Below average state,JHARKHAND,60-69,0,UP,JHARKHAND,20,B0101,Rural,Underperformance,0.275465962,83502,258627,342129,51263,96202,147465,127599,165403,293002,49802,38496,88298,0.417529454,375004,143568,518572,14989,7536,22525,1,4,635907,529,606094,1242001
Not considered,Below average state,KERALA,60-69,0,UP,KERALA,32,B0101,Rural,Underperformance,0.275855615,68384,276494,344878,8807,12403,21210,33656,55863,89519,14099,15288,29387,0.629035716,542159,244269,786428,17142,9900,27042,1,4,658298,539,591914,1250212
Not considered,Below average state,LAKSHADWEEP,60-69,0,UP,LAKSHADWEEP,31,B0101,Rural,Underperformance,0.086021505,5,59,64,7,42,49,6,51,57,1,22,23,0.806451613,330,270,600,22,56,78,1,4,342,528,402,744
Not considered,Below average state,MADHYA PRADESH,60-69,0,UP,MADHYA PRADESH,23,B0101,Rural,Underperformance,0.456553438,325246,812282,1137528,80666,81580,162246,226897,147900,374797,64883,34963,99846,0.352945851,664964,214420,879384,22970,9497,32467,1,3,1281990,554,1209565,2491555
Not considered,Below average state,MANIPUR,60-69,0,UP,MANIPUR,14,B0101,Rural,Underperformance,0.57606432,16258,29383,45641,1467,1185,2652,5369,3573,8942,1631,807,2438,0.280301405,15419,6789,22208,924,420,1344,1,3,38677,551,40552,79229
Not considered,Below average state,NAGALAND,60-69,0,UP,NAGALAND,13,B0101,Rural,Underperformance,0.741026729,15457,19475,34932,288,248,536,2163,1561,3724,657,427,1084,0.156979211,4035,3365,7400,170,140,310,1,3,22312,567,24828,47140
Not considered,Below average state,ODISHA,60-69,0,UP,ODISHA,21,B0101,Rural,Underperformance,0.300613734,89878,547758,637636,53785,75729,129514,153434,164531,317965,50344,40049,90393,0.506865732,775487,299633,1075120,29186,14460,43646,1,3,1069143,558,1051971,2121114
Not considered,Below average state,PUDUCHERRY,60-69,0,UP,PUDUCHERRY,34,B0101,Rural,Underperformance,0.276833836,1499,4562,6061,104,191,295,518,840,1358,201,257,458,0.640221065,9900,4117,14017,163,90,253,1,4,12118,493,9776,21894
Not considered,Below average state,PUNJAB,60-69,0,UP,PUNJAB,3,B0101,Rural,Underperformance,0.351084425,47212,356830,404042,9167,15421,24588,24849,30429,55278,9997,9394,19391,0.584033402,501133,170996,672129,19581,8569,28150,1,3,583191,556,567649,1150840
Not considered,Below average state,UTTAR PRADESH,60-69,0,UP,UTTAR PRADESH,9,B0101,Rural,Underperformance,0.388107644,477971,2499762,2977733,117156,283823,400979,412851,565197,978048,144044,152683,296727,0.445742496,2690970,728963,3419933,103504,51097,154601,1,4,3725836,507,3946605,7672441
Not considered,Below average state,UTTARAKHAND,60-69,0,UP,UTTARAKHAND,5,B0101,Rural,Underperformance,0.386662679,54382,103335,157717,6286,11381,17667,27713,26811,54524,13029,8735,21764,0.42630788,114666,59222,173888,2726,2248,4974,1,4,209790,544,198103,407893
Not considered,Below average state,ASSAM,60+,0,UP,ASSAM,18,B0101,Rural,Underperformance,0.360488305,97502,532456,629958,14267,18696,32963,69832,63157,132989,19093,15743,34836,0.543475213,676797,272933,949730,23064,9268,32332,1,4,863224,516,884289,1747513
Not considered,Below average state,CHANDIGARH,60+,0,UP,CHANDIGARH,4,B0101,Rural,Underperformance,0.207650273,19,209,228,0,6,6,6,21,27,3,6,9,0.759562842,459,375,834,6,15,21,1,4,487,538,611,1098
Not considered,Below average state,DADRA & NAGAR HAVELI,60+,0,UP,DADRA & NAGAR HAVELI,26,B0101,Rural,Underperformance,0.321023385,659,2114,2773,60,56,116,696,325,1021,139,94,233,0.533804121,3394,1217,4611,54,15,69,1,4,4888,523,3750,8638
Not considered,Below average state,DELHI,60+,0,UP,DELHI,7,B0101,Rural,Underperformance,0.218323874,817,5107,5924,55,172,227,213,416,629,48,117,165,0.752413946,12598,7818,20416,152,183,335,1,4,13676,500,13458,27134
Not considered,Below average state,GOA,60+,0,UP,GOA,30,B0101,Rural,Underperformance,0.153008953,2667,7399,10066,212,463,675,1097,2077,3174,505,762,1267,0.779485309,32432,18848,51280,611,484,1095,1,4,36701,535,29086,65787
Not considered,Below average state,JAMMU & KASHMIR,60+,0,UP,JAMMU & KASHMIR,1,B0101,Rural,Underperformance,0.207154021,13412,121646,135058,7978,28624,36602,27471,55880,83351,15808,22003,37811,0.607005855,252789,142960,395749,10829,6922,17751,1,4,309480,524,342489,651969
Not considered,Below average state,JHARKHAND,60+,0,UP,JHARKHAND,20,B0101,Rural,Underperformance,0.240206977,103520,336746,440266,60997,119611,180608,156249,216555,372804,62980,55295,118275,0.491862722,605236,296280,901516,19055,10824,29879,1,4,927985,529,904876,1832861
Not considered,Below average state,KERALA,60+,0,UP,KERALA,32,B0101,Rural,Underperformance,0.204769671,85503,364489,449992,10413,14963,25376,42141,74639,116780,17772,21935,39707,0.724020638,1061816,529257,1591073,22020,12350,34370,1,4,1207232,539,990320,2197552
Not considered,Below average state,LAKSHADWEEP,60+,0,UP,LAKSHADWEEP,31,B0101,Rural,Underperformance,0.064604186,5,66,71,7,58,65,8,68,76,1,28,29,0.839854413,500,423,923,27,65,92,1,4,514,528,585,1099
Not considered,Below average state,MADHYA PRADESH,60+,0,UP,MADHYA PRADESH,23,B0101,Rural,Underperformance,0.38236416,435165,1168702,1603867,102511,111567,214078,300202,220621,520823,94563,62031,156594,0.45613867,1336318,577004,1913322,32616,15604,48220,1,3,2166248,554,2028358,4194606
Not considered,Below average state,MANIPUR,60+,0,UP,MANIPUR,14,B0101,Rural,Underperformance,0.496265623,22923,42393,65316,1963,1692,3655,7484,5545,13029,2396,1479,3875,0.375299168,31790,17605,49395,1274,643,1917,1,3,64593,551,67022,131615
Not considered,Below average state,NAGALAND,60+,0,UP,NAGALAND,13,B0101,Rural,Underperformance,0.676791536,23575,31438,55013,430,386,816,3427,2803,6230,1163,871,2034,0.22154149,10008,8000,18008,254,218,472,1,3,38173,567,43112,81285
Not considered,Below average state,ODISHA,60+,0,UP,ODISHA,21,B0101,Rural,Underperformance,0.244440936,115131,725661,840792,64363,94807,159170,188799,223709,412508,63712,59991,123703,0.599668048,1357795,704855,2062650,38427,20955,59382,1,3,1725437,558,1714216,3439653
Not considered,Below average state,PUDUCHERRY,60+,0,UP,PUDUCHERRY,34,B0101,Rural,Underperformance,0.222289289,1952,6150,8102,130,234,364,650,1097,1747,277,355,632,0.71243964,17337,8630,25967,225,141,366,1,4,20216,493,16232,36448
Not considered,Below average state,PUNJAB,60+,0,UP,PUNJAB,3,B0101,Rural,Underperformance,0.291515087,64483,506219,570702,11583,21116,32699,32903,44402,77305,12801,14184,26985,0.655213489,863566,419152,1282718,25279,12790,38069,1,3,973753,556,983957,1957710
Not considered,Below average state,UTTAR PRADESH,60+,0,UP,UTTAR PRADESH,9,B0101,Rural,Underperformance,0.349804378,680089,3673740,4353829,154466,389353,543819,563622,832554,1396176,202415,242695,445110,0.502259195,4522707,1728646,6251353,137431,78191,215622,1,4,5968833,507,6477635,12446468
Not considered,Below average state,UTTARAKHAND,60+,0,UP,UTTARAKHAND,5,B0101,Rural,Underperformance,0.326670749,73488,147346,220834,7954,14648,22602,37156,38243,75399,19446,14551,33997,0.5115042,220323,125461,345784,3723,3110,6833,1,4,350413,544,325601,676014
Not considered,Below average state,ASSAM,70-79,0,UP,ASSAM,18,B0101,Rural,Underperformance,0.311714332,20197,129626,149823,2504,3842,6346,13121,16124,29245,3890,4667,8557,0.609636694,195729,97288,293017,4430,2053,6483,1,4,232937,516,247705,480642
Not considered,Below average state,CHANDIGARH,70-79,0,UP,CHANDIGARH,4,B0101,Rural,Underperformance,0.13671875,1,34,35,0,0,0,1,3,4,0,0,0,0.84765625,115,102,217,0,2,2,1,4,117,538,139,256
Not considered,Below average state,DADRA & NAGAR HAVELI,70-79,0,UP,DADRA & NAGAR HAVELI,26,B0101,Rural,Underperformance,0.202054795,102,311,413,11,3,14,94,62,156,28,20,48,0.6981409,1025,402,1427,4,2,6,1,4,1249,523,795,2044
Not considered,Below average state,DELHI,70-79,0,UP,DELHI,7,B0101,Rural,Underperformance,0.137627651,100,776,876,7,23,30,26,74,100,10,19,29,0.842105263,3078,2282,5360,21,28,49,1,4,3214,500,3151,6365
Not considered,Below average state,GOA,70-79,0,UP,GOA,30,B0101,Rural,Underperformance,0.099622311,508,1312,1820,32,61,93,189,397,586,87,144,231,0.855657124,9719,5913,15632,97,75,172,1,4,10503,535,7766,18269
Not considered,Below average state,JAMMU & KASHMIR,70-79,0,UP,JAMMU & KASHMIR,1,B0101,Rural,Underperformance,0.17550078,3230,30291,33521,1542,6468,8010,5602,14365,19967,3459,6275,9734,0.66899823,77954,49826,127780,2311,1759,4070,1,4,90245,524,100757,191002
Not considered,Below average state,JHARKHAND,70-79,0,UP,JHARKHAND,20,B0101,Rural,Underperformance,0.179595047,16110,64278,80388,7661,19141,26802,23039,42141,65180,10752,13543,24295,0.620508616,171447,106297,277744,3274,2678,5952,1,4,221348,529,226259,447607
Not considered,Below average state,KERALA,70-79,0,UP,KERALA,32,B0101,Rural,Underperformance,0.135878505,14255,73883,88138,1321,2192,3513,7060,15822,22882,3103,5437,8540,0.81567957,341810,187283,529093,3707,1964,5671,1,4,366228,539,282425,648653
Not considered,Below average state,LAKSHADWEEP,70-79,0,UP,LAKSHADWEEP,31,B0101,Rural,Underperformance,0.011320755,0,3,3,0,7,7,2,9,11,0,4,4,0.932075472,135,112,247,2,8,10,1,4,137,528,128,265
Not considered,Below average state,MADHYA PRADESH,70-79,0,UP,MADHYA PRADESH,23,B0101,Rural,Underperformance,0.303631074,86218,281669,367887,17024,23670,40694,58153,57029,115182,23686,20416,44102,0.564905808,456886,227568,684454,7525,4520,12045,1,3,624943,554,586682,1211625
Not considered,Below average state,MANIPUR,70-79,0,UP,MANIPUR,14,B0101,Rural,Underperformance,0.413309789,5060,9920,14980,387,381,768,1636,1467,3103,596,474,1070,0.471553912,10690,6401,17091,242,136,378,1,3,17982,551,18262,36244
Not considered,Below average state,NAGALAND,70-79,0,UP,NAGALAND,13,B0101,Rural,Underperformance,0.646070838,6198,8650,14848,101,91,192,956,851,1807,340,279,619,0.248368288,3332,2376,5708,53,50,103,1,3,10826,567,12156,22982
Not considered,Below average state,ODISHA,70-79,0,UP,ODISHA,21,B0101,Rural,Underperformance,0.171962766,20408,148218,168626,8222,15488,23710,28830,49102,77932,11308,16424,27732,0.720282359,433233,273073,706306,7444,5167,12611,1,3,493779,558,486817,980596
Not considered,Below average state,PUDUCHERRY,70-79,0,UP,PUDUCHERRY,34,B0101,Rural,Underperformance,0.155704445,350,1300,1650,22,34,56,110,207,317,60,77,137,0.801453241,5368,3125,8493,52,37,89,1,4,5888,493,4709,10597
Not considered,Below average state,PUNJAB,70-79,0,UP,PUNJAB,3,B0101,Rural,Underperformance,0.242294052,12452,116470,128922,1781,4472,6253,5832,10696,16528,2123,3733,5856,0.715637797,231197,149586,380783,4253,3225,7478,1,3,251604,556,280485,532089
Not considered,Below average state,UTTAR PRADESH,70-79,0,UP,UTTAR PRADESH,9,B0101,Rural,Underperformance,0.31235739,149258,889623,1038881,26883,78481,105364,110270,198730,309000,43558,66862,110420,0.561536794,1246220,621416,1867636,25191,19621,44812,1,4,1549306,507,1776631,3325937
Not considered,Below average state,UTTARAKHAND,70-79,0,UP,UTTARAKHAND,5,B0101,Rural,Underperformance,0.260677265,15184,34206,49390,1268,2603,3871,7598,9138,16736,5157,4512,9669,0.599958832,70227,43446,113673,735,653,1388,1,4,98166,544,91302,189468
Not considered,Below average state,ASSAM,80+,0,UP,ASSAM,18,B0101,Rural,Underperformance,0.212782836,6244,35331,41575,1030,1499,2529,4239,5045,9284,1107,1420,2527,0.726767902,86390,55611,142001,1666,972,2638,1,4,97980,516,97407,195387
Not considered,Below average state,CHANDIGARH,80+,0,UP,CHANDIGARH,4,B0101,Rural,Underperformance,0.122641509,2,11,13,0,0,0,0,1,1,1,1,2,0.849056604,48,42,90,1,0,1,1,4,51,538,55,106
Not considered,Below average state,DADRA & NAGAR HAVELI,80+,0,UP,DADRA & NAGAR HAVELI,26,B0101,Rural,Underperformance,0.164410058,27,58,85,2,4,6,20,11,31,5,5,10,0.756286267,267,124,391,4,0,4,1,4,319,523,198,517
Not considered,Below average state,DELHI,80+,0,UP,DELHI,7,B0101,Rural,Underperformance,0.105228326,31,287,318,1,8,9,6,21,27,3,9,12,0.881866314,1500,1165,2665,13,15,28,1,4,1540,500,1482,3022
Not considered,Below average state,GOA,80+,0,UP,GOA,30,B0101,Rural,Underperformance,0.083543904,179,350,529,9,11,20,52,83,135,18,34,52,0.886923563,3670,1946,5616,41,25,66,1,4,3919,535,2413,6332
Not considered,Below average state,JAMMU & KASHMIR,80+,0,UP,JAMMU & KASHMIR,1,B0101,Rural,Underperformance,0.119002143,1297,9918,11215,682,2254,2936,1940,4691,6631,1068,2280,3348,0.775110885,40225,32823,73048,1035,741,1776,1,4,44530,524,49712,94242
Not considered,Below average state,JHARKHAND,80+,0,UP,JHARKHAND,20,B0101,Rural,Underperformance,0.123899674,3908,13841,17749,2073,4268,6341,5611,9011,14622,2426,3256,5682,0.734365074,58785,46415,105200,792,610,1402,1,4,70730,529,72523,143253
Not considered,Below average state,KERALA,80+,0,UP,KERALA,32,B0101,Rural,Underperformance,0.056835416,2864,14112,16976,285,368,653,1425,2954,4379,570,1210,1780,0.922544336,177847,97705,275552,1171,486,1657,1,4,182706,539,115981,298687
Not considered,Below average state,LAKSHADWEEP,80+,0,UP,LAKSHADWEEP,31,B0101,Rural,Underperformance,0.044444444,0,4,4,0,9,9,0,8,8,0,2,2,0.844444444,35,41,76,3,1,4,1,4,35,528,55,90
Not considered,Below average state,MADHYA PRADESH,80+,0,UP,MADHYA PRADESH,23,B0101,Rural,Underperformance,0.20033942,23701,74751,98452,4821,6317,11138,15152,15692,30844,5994,6652,12646,0.711163024,214468,135016,349484,2121,1587,3708,1,3,259315,554,232111,491426
Not considered,Below average state,MANIPUR,80+,0,UP,MANIPUR,14,B0101,Rural,Underperformance,0.290856152,1605,3090,4695,109,126,235,479,505,984,169,198,367,0.625449139,5681,4415,10096,108,87,195,1,3,7934,551,8208,16142
Not considered,Below average state,NAGALAND,80+,0,UP,NAGALAND,13,B0101,Rural,Underperformance,0.468780794,1920,3313,5233,41,47,88,308,391,699,166,165,331,0.438950103,2641,2259,4900,31,28,59,1,3,5035,567,6128,11163
Not considered,Below average state,ODISHA,80+,0,UP,ODISHA,21,B0101,Rural,Underperformance,0.102176994,4845,29685,34530,2356,3590,5946,6535,10076,16611,2060,3518,5578,0.832164004,149075,132149,281224,1797,1328,3125,1,3,162515,558,175428,337943
Not considered,Below average state,PUDUCHERRY,80+,0,UP,PUDUCHERRY,34,B0101,Rural,Underperformance,0.098812231,103,288,391,4,9,13,22,50,72,16,21,37,0.873641648,2069,1388,3457,10,14,24,1,4,2210,493,1747,3957
Not considered,Below average state,PUNJAB,80+,0,UP,PUNJAB,3,B0101,Rural,Underperformance,0.137338462,4819,32919,37738,635,1223,1858,2222,3277,5499,681,1057,1738,0.8363242,131236,98570,229806,1445,996,2441,1,3,138958,556,135823,274781
Not considered,Below average state,UTTAR PRADESH,80+,0,UP,UTTAR PRADESH,9,B0101,Rural,Underperformance,0.232868813,52860,284355,337215,10427,27049,37476,40501,68627,109128,14813,23150,37963,0.665555318,585517,378267,963784,8736,7473,16209,1,4,693691,507,754399,1448090
Not considered,Below average state,UTTARAKHAND,80+,0,UP,UTTARAKHAND,5,B0101,Rural,Underperformance,0.174526083,3922,9805,13727,400,664,1064,1845,2294,4139,1260,1304,2564,0.740251484,35430,22793,58223,262,209,471,1,4,42457,544,36196,78653
Not considered,Below average state,ASSAM,Age not stated,0,UP,ASSAM,18,B0101,Rural,Underperformance,0.215194087,714,2518,3232,294,363,657,750,626,1376,116,103,219,0.678607098,5587,4605,10192,344,254,598,1,4,7167,516,7852,15019
Not considered,Below average state,CHANDIGARH,Age not stated,0,UP,CHANDIGARH,4,B0101,Rural,Underperformance,0.166666667,0,1,1,0,0,0,0,0,0,0,0,0,0.833333333,2,3,5,0,0,0,1,4,2,538,4,6
Not considered,Below average state,DADRA & NAGAR HAVELI,Age not stated,0,UP,DADRA & NAGAR HAVELI,26,B0101,Rural,Underperformance,0.177272727,11,28,39,1,1,2,10,5,15,1,0,1,0.75,85,80,165,0,2,2,1,4,107,523,113,220
Not considered,Below average state,DELHI,Age not stated,0,UP,DELHI,7,B0101,Rural,Underperformance,0.16827853,7,80,87,5,4,9,6,8,14,0,0,0,0.804642166,223,193,416,10,7,17,1,4,236,500,281,517
Not considered,Below average state,GOA,Age not stated,0,UP,GOA,30,B0101,Rural,Underperformance,0.38671024,131,224,355,10,18,28,21,37,58,9,9,18,0.530501089,273,214,487,15,8,23,1,4,434,535,484,918
Not considered,Below average state,JAMMU & KASHMIR,Age not stated,0,UP,JAMMU & KASHMIR,1,B0101,Rural,Underperformance,0.151249654,226,1414,1640,133,292,425,278,438,716,110,142,252,0.75947616,3370,4865,8235,260,246,506,1,4,3984,524,6859,10843
Not considered,Below average state,JHARKHAND,Age not stated,0,UP,JHARKHAND,20,B0101,Rural,Underperformance,0.203163401,3355,8218,11573,1922,3375,5297,4028,4974,9002,1395,836,2231,0.599641879,18061,16097,34158,842,718,1560,1,4,26839,529,30125,56964
Not considered,Below average state,KERALA,Age not stated,0,UP,KERALA,32,B0101,Rural,Underperformance,0.202572533,929,2583,3512,184,258,442,387,503,890,115,94,209,0.734037031,7227,5499,12726,758,350,1108,1,4,8658,539,8679,17337
Not considered,Below average state,LAKSHADWEEP,Age not stated,0,UP,LAKSHADWEEP,31,B0101,Rural,Underperformance,0.111111111,0,3,3,0,6,6,1,7,8,0,2,2,0.518518519,6,8,14,0,1,1,1,4,7,528,20,27
Not considered,Below average state,MADHYA PRADESH,Age not stated,0,UP,MADHYA PRADESH,23,B0101,Rural,Underperformance,0.214373283,3218,6924,10142,948,1219,2167,2244,1917,4161,489,410,899,0.678672585,16484,15624,32108,368,390,758,1,3,22435,554,24875,47310
Not considered,Below average state,MANIPUR,Age not stated,0,UP,MANIPUR,14,B0101,Rural,Underperformance,0.301840057,572,1134,1706,110,90,200,298,174,472,53,49,102,0.596602972,1586,1786,3372,130,115,245,1,3,2509,551,3143,5652
Not considered,Below average state,NAGALAND,Age not stated,0,UP,NAGALAND,13,B0101,Rural,Underperformance,0.349293564,164,281,445,18,13,31,34,43,77,39,35,74,0.532182104,305,373,678,14,19,33,1,3,542,567,732,1274
Not considered,Below average state,ODISHA,Age not stated,0,UP,ODISHA,21,B0101,Rural,Underperformance,0.205451108,4079,15482,19561,3356,3968,7324,7015,6404,13419,1430,1038,2468,0.627686167,34216,25546,59762,1958,1600,3558,1,3,46740,558,48470,95210
Not considered,Below average state,PUDUCHERRY,Age not stated,0,UP,PUDUCHERRY,34,B0101,Rural,Underperformance,0.176706827,17,71,88,4,10,14,8,15,23,2,7,9,0.759036145,213,165,378,10,10,20,1,4,240,493,258,498
Not considered,Below average state,PUNJAB,Age not stated,0,UP,PUNJAB,3,B0101,Rural,Underperformance,0.23015873,1112,5703,6815,286,522,808,650,886,1536,149,173,322,0.707092199,11866,9071,20937,573,441,1014,1,3,13777,556,15833,29610
Not considered,Below average state,UTTAR PRADESH,Age not stated,0,UP,UTTAR PRADESH,9,B0101,Rural,Underperformance,0.210511502,46917,199893,246810,14384,35276,49660,47740,65522,113262,12158,13229,25387,0.671230692,441235,345736,786971,12577,12757,25334,1,4,548050,507,624380,1172430
Not considered,Below average state,UTTARAKHAND,Age not stated,0,UP,UTTARAKHAND,5,B0101,Rural,Underperformance,0.24197861,776,1758,2534,197,314,511,497,563,1060,160,125,285,0.629583652,3291,3302,6593,132,132,264,1,4,4724,544,5748,10472
Not considered,Below average state,ASSAM,Oct-14,0,UP,ASSAM,18,B0101,Rural,Underperformance,0.023409509,19059,53505,72564,17388,30752,48140,39185,54001,93186,19487,23936,43423,0.932519745,1434271,1456322,2890593,53711,60432,114143,1,4,1512002,516,1587764,3099766
Not considered,Below average state,CHANDIGARH,Oct-14,0,UP,CHANDIGARH,4,B0101,Rural,Underperformance,0.041781632,37,69,106,0,2,2,9,5,14,5,9,14,0.947181711,1065,1338,2403,10,28,38,1,4,1116,538,1421,2537
Not considered,Below average state,DADRA & NAGAR HAVELI,Oct-14,0,UP,DADRA & NAGAR HAVELI,26,B0101,Rural,Underperformance,0.026261632,313,274,587,84,36,120,307,117,424,170,140,310,0.940900143,9998,11033,21031,84,72,156,1,4,10788,523,11564,22352
Not considered,Below average state,DELHI,Oct-14,0,UP,DELHI,7,B0101,Rural,Underperformance,0.010069089,109,353,462,14,43,57,38,74,112,17,32,49,0.986421986,20240,25020,45260,212,342,554,1,4,20404,500,25479,45883
Not considered,Below average state,GOA,Oct-14,0,UP,GOA,30,B0101,Rural,Underperformance,0.03309653,642,737,1379,124,129,253,248,250,498,49,45,94,0.952695243,19423,20272,39695,617,610,1227,1,4,20362,535,21304,41666
Not considered,Below average state,JAMMU & KASHMIR,Oct-14,0,UP,JAMMU & KASHMIR,1,B0101,Rural,Underperformance,0.011581829,4473,8235,12708,7921,9475,17396,14859,14310,29169,13724,13709,27433,0.936832186,488669,539257,1027926,24586,26473,51059,1,4,521725,524,575511,1097236
Not considered,Below average state,JHARKHAND,Oct-14,0,UP,JHARKHAND,20,B0101,Rural,Underperformance,0.01711576,22903,32504,55407,25951,32809,58760,58960,60175,119135,59772,56298,116070,0.910227135,1433511,1513069,2946580,25750,31052,56802,1,4,1575146,529,1662046,3237192
Not considered,Below average state,KERALA,Oct-14,0,UP,KERALA,32,B0101,Rural,Underperformance,0.005026218,2546,4990,7536,2148,2489,4637,3729,4123,7852,473,600,1073,0.989021155,729693,753184,1482877,25499,27393,52892,1,4,736441,539,762897,1499338
Not considered,Below average state,LAKSHADWEEP,Oct-14,0,UP,LAKSHADWEEP,31,B0101,Rural,Underperformance,0.002159827,2,1,3,0,4,4,1,6,7,0,0,0,0.992800576,774,605,1379,24,17,41,1,4,777,528,612,1389
Not considered,Below average state,MADHYA PRADESH,Oct-14,0,UP,MADHYA PRADESH,23,B0101,Rural,Underperformance,0.028545441,78153,106851,185004,39354,45168,84522,91405,85070,176475,68833,66724,135557,0.923309163,2904543,3079456,5983999,41083,49894,90977,1,3,3142934,554,3338101,6481035
Not considered,Below average state,MANIPUR,Oct-14,0,UP,MANIPUR,14,B0101,Rural,Underperformance,0.032169189,3458,3968,7426,2113,2181,4294,3988,4023,8011,2475,2445,4920,0.911814141,101707,108778,210485,4868,5129,9997,1,3,111628,551,119214,230842
Not considered,Below average state,NAGALAND,Oct-14,0,UP,NAGALAND,13,B0101,Rural,Underperformance,0.043687793,3751,4163,7914,2140,2391,4531,6041,6336,12377,12149,12850,24999,0.749984819,64550,71309,135859,2484,2730,5214,1,3,86491,567,94658,181149
Not considered,Below average state,ODISHA,Oct-14,0,UP,ODISHA,21,B0101,Rural,Underperformance,0.016159946,22896,36983,59879,39234,38414,77648,65554,58553,124107,34991,30789,65780,0.932593979,1709412,1746218,3455630,45063,52366,97429,1,3,1832853,558,1872543,3705396
Not considered,Below average state,PUDUCHERRY,Oct-14,0,UP,PUDUCHERRY,34,B0101,Rural,Underperformance,0.010013861,119,235,354,36,34,70,75,66,141,8,13,21,0.985403525,17177,17658,34835,173,201,374,1,4,17379,493,17972,35351
Not considered,Below average state,PUNJAB,Oct-14,0,UP,PUNJAB,3,B0101,Rural,Underperformance,0.025614982,11737,31010,42747,5463,8422,13885,11293,15461,26754,3631,4485,8116,0.953490114,710801,880410,1591211,16135,22733,38868,1,3,737462,556,931366,1668828
Not considered,Below average state,UTTAR PRADESH,Oct-14,0,UP,UTTAR PRADESH,9,B0101,Rural,Underperformance,0.022355846,149746,314673,464419,74394,134650,209044,223618,284620,508238,111756,128444,240200,0.941616419,9326498,10234585,19561083,146394,207155,353549,1,4,9811618,507,10962322,20773940
Not considered,Below average state,UTTARAKHAND,Oct-14,0,UP,UTTARAKHAND,5,B0101,Rural,Underperformance,0.018194485,6127,9073,15200,2211,3172,5383,7821,7535,15356,11394,10248,21642,0.937518703,375498,407722,783220,4489,6015,10504,1,4,400840,544,434578,835418
Not considered,Below average state,ASSAM,Total,0,UP,ASSAM,18,B0101,Rural,Underperformance,0.272727486,1430841,5880174,7311015,593640,800239,1393879,1361814,1140305,2502119,317776,237373,555149,0.613225283,10017614,6421137,16438751,1293142,760525,2053667,1,4,13128045,516,13678989,26807034
Not considered,Below average state,CHANDIGARH,Total,0,UP,CHANDIGARH,4,B0101,Rural,Underperformance,0.402987134,1327,10356,11683,70,103,173,261,209,470,98,99,197,0.574005726,10155,6486,16641,599,371,970,1,4,11841,538,17150,28991
Not considered,Below average state,DADRA & NAGAR HAVELI,Total,0,UP,DADRA & NAGAR HAVELI,26,B0101,Rural,Underperformance,0.339739179,13972,48239,62211,2300,2217,4517,12391,6115,18506,1957,1449,3406,0.54059766,56489,42502,98991,2377,1373,3750,1,4,84809,523,98305,183114
Not considered,Below average state,DELHI,Total,0,UP,DELHI,7,B0101,Rural,Underperformance,0.282811747,14942,103568,118510,1381,4606,5987,3173,6426,9599,612,1506,2118,0.689226856,173994,114821,288815,10617,10036,20653,1,4,192721,500,226321,419042
Not considered,Below average state,GOA,Total,0,UP,GOA,30,B0101,Rural,Underperformance,0.298186979,42477,122042,164519,8830,15622,24452,14837,24120,38957,5236,6824,12060,0.609345859,213745,122450,336195,33682,18753,52435,1,4,276295,535,275436,551731
Not considered,Below average state,JAMMU & KASHMIR,Total,0,UP,JAMMU & KASHMIR,1,B0101,Rural,Underperformance,0.183333663,216657,1453157,1669814,242204,466812,709016,447025,566924,1013949,237393,191925,429318,0.658205919,3432508,2562471,5994979,441403,296792,738195,1,4,4333583,524,4774477,9108060
Not considered,Below average state,JHARKHAND,Total,0,UP,JHARKHAND,20,B0101,Rural,Underperformance,0.195043934,1323418,3563422,4886840,1270873,1970607,3241480,2214683,2415831,4630514,754909,504889,1259798,0.569861481,7985577,6292344,14277921,509557,381904,891461,1,4,12278587,529,12776486,25055073
Not considered,Below average state,KERALA,Total,0,UP,KERALA,32,B0101,Rural,Underperformance,0.282190653,1187113,3743078,4930191,297301,383270,680571,481882,635147,1117029,165461,129276,294737,0.637003721,7228625,3900553,11129178,1447333,609165,2056498,1,4,9063081,539,8408054,17471135
Not considered,Below average state,LAKSHADWEEP,Total,0,UP,LAKSHADWEEP,31,B0101,Rural,Underperformance,0.157343894,347,1878,2225,478,1741,2219,378,1543,1921,141,366,507,0.670956792,6032,3456,9488,1843,751,2594,1,4,6898,528,7243,14141
Not considered,Below average state,MADHYA PRADESH,Total,0,UP,MADHYA PRADESH,23,B0101,Rural,Underperformance,0.318310204,5241375,11488183,16729558,1903162,2092901,3996063,3868283,2695259,6563542,863563,558535,1422098,0.529748501,15434795,12407411,27842206,692450,567113,1259563,1,3,25408016,554,27149388,52557404
Not considered,Below average state,MANIPUR,Total,0,UP,MANIPUR,14,B0101,Rural,Underperformance,0.35292238,271000,442482,713482,58693,46761,105454,120773,71800,192573,33303,19803,53106,0.525553016,569680,492799,1062479,73046,62931,135977,1,3,994756,551,1026884,2021640
Not considered,Below average state,NAGALAND,Total,0,UP,NAGALAND,13,B0101,Rural,Underperformance,0.403310466,251290,316384,567674,27730,28390,56120,63608,47710,111318,41550,39818,81368,0.459793568,325616,321560,647176,27088,26631,53719,1,3,682064,567,725472,1407536
Not considered,Below average state,ODISHA,Total,0,UP,ODISHA,21,B0101,Rural,Underperformance,0.246605902,1577956,7045991,8623947,1646431,1914028,3560459,2867502,2426755,5294257,716682,468828,1185510,0.568102051,12222219,7644629,19866848,1246482,861961,2108443,1,3,17384359,558,17586203,34970562
Not considered,Below average state,PUDUCHERRY,Total,0,UP,PUDUCHERRY,34,B0101,Rural,Underperformance,0.309180162,31120,91068,122188,3542,5770,9312,8260,11706,19966,2791,2931,5722,0.625819838,158122,89202,247324,13665,8438,22103,1,4,200293,493,194907,395200
Not considered,Below average state,PUNJAB,Total,0,UP,PUNJAB,3,B0101,Rural,Underperformance,0.294451537,689185,4417839,5107024,188034,325672,513706,361374,461224,822598,132821,116756,249577,0.643730939,7067336,4097657,11164993,603793,381069,984862,1,3,8250716,556,9093476,17344192
Not considered,Below average state,UTTAR PRADESH,Total,0,UP,UTTAR PRADESH,9,B0101,Rural,Underperformance,0.21593745,5726470,27812347,33538817,2259809,5893034,8152843,5960095,8531773,14491868,1911536,2008759,3920295,0.665517059,60726182,42640116,103366298,3092626,2970426,6063052,1,4,74324283,507,80992995,155317278
Not considered,Below average state,UTTARAKHAND,Total,0,UP,UTTARAKHAND,5,B0101,Rural,Underperformance,0.283834739,674809,1322523,1997332,152917,234395,387312,352136,306695,658831,131914,97456,229370,0.589945735,2359053,1792368,4151421,135315,132169,267484,1,4,3517912,544,3519042,7036954
States needing Special Attention,Below average state,BIHAR,15-19,0,UP,BIHAR,10,B0101,Rural,Underperformance,0.11430992,208538,733802,942340,145658,427952,573610,268069,533104,801173,95282,136513,231795,0.760386592,3049342,3219079,6268421,343614,597218,940832,1,4,3621231,446,4622498,8243729
States needing Special Attention,Below average state,HARYANA,15-19,0,UP,HARYANA,6,B0101,Rural,Underperformance,0.102137733,33163,150684,183847,21847,52472,74319,42100,59814,101914,24191,28972,53163,0.811707947,706146,754921,1461067,70731,119265,189996,1,4,805600,505,994391,1799991
States needing Special Attention,Below average state,BIHAR,15-59,0,UP,BIHAR,10,B0101,Rural,Underperformance,0.337035919,3183282,12799025,15982307,1745847,4110900,5856747,3446325,5341229,8787554,975630,901856,1877486,0.43805903,15180863,5591979,20772842,1789086,1413520,3202606,1,4,22786100,446,24634089,47420189
States needing Special Attention,Below average state,HARYANA,15-59,0,UP,HARYANA,6,B0101,Rural,Underperformance,0.407611346,696640,3330651,4027291,206490,415573,622063,592922,517919,1110841,169538,113465,283003,0.45131451,3190374,1268714,4459088,325143,295663,620806,1,4,4649474,505,5230749,9880223
States needing Special Attention,Below average state,BIHAR,20-24,0,UP,BIHAR,10,B0101,Rural,Underperformance,0.266822972,400375,1470335,1870710,259198,656477,915675,483183,794854,1278037,137379,142632,280011,0.510949639,2345587,1236708,3582295,363141,435036,798177,1,4,3366524,446,3644529,7011053
States needing Special Attention,Below average state,HARYANA,20-24,0,UP,HARYANA,6,B0101,Rural,Underperformance,0.329612879,87032,459657,546689,39336,93901,133237,86714,103710,190424,27453,26048,53501,0.523318455,567803,300162,867965,97519,115519,213038,1,4,769002,505,889577,1658579
States needing Special Attention,Below average state,BIHAR,25-29,0,UP,BIHAR,10,B0101,Rural,Underperformance,0.356160809,492079,1902279,2394358,291550,675903,967453,552137,846652,1398789,152331,133778,286109,0.393210573,2185979,457453,2643432,305162,180210,485372,1,4,3382526,446,3340162,6722688
States needing Special Attention,Below average state,HARYANA,25-29,0,UP,HARYANA,6,B0101,Rural,Underperformance,0.479015576,105080,557993,663073,36120,74712,110832,91676,89050,180726,24210,15786,39996,0.361530976,425546,74900,500446,59031,34368,93399,1,4,646512,505,737729,1384241
States needing Special Attention,Below average state,BIHAR,30-34,0,UP,BIHAR,10,B0101,Rural,Underperformance,0.396500009,502083,1957424,2459507,279665,614990,894655,537618,782028,1319646,146114,117960,264074,0.348186632,1942823,216994,2159817,245604,80310,325914,1,4,3128638,446,3074406,6203044
States needing Special Attention,Below average state,HARYANA,30-34,0,UP,HARYANA,6,B0101,Rural,Underperformance,0.514835633,107365,497155,604520,31078,54359,85437,89085,68010,157095,22274,10683,32957,0.323307784,350067,29561,379628,34942,10506,45448,1,4,568791,505,605409,1174200
States needing Special Attention,Below average state,BIHAR,35-39,0,UP,BIHAR,10,B0101,Rural,Underperformance,0.423498449,475086,1926680,2401766,251630,560850,812480,490208,726605,1216813,132608,109043,241651,0.3193336,1670984,140037,1811021,194671,46917,241588,1,4,2768886,446,2902365,5671251
States needing Special Attention,Below average state,HARYANA,35-39,0,UP,HARYANA,6,B0101,Rural,Underperformance,0.537021701,110301,479141,589442,27340,47513,74853,85898,61082,146980,20841,9363,30204,0.30155164,311063,19924,330987,24886,5243,30129,1,4,528103,505,569510,1097613
States needing Special Attention,Below average state,BIHAR,40-49,0,UP,BIHAR,10,B0101,Rural,Underperformance,0.441051037,683257,2947652,3630909,335575,766646,1102221,691944,1041558,1733502,188163,159182,347345,0.306185887,2345662,174983,2520645,225575,48075,273650,1,4,3909026,446,4323375,8232401
States needing Special Attention,Below average state,HARYANA,40-49,0,UP,HARYANA,6,B0101,Rural,Underperformance,0.539761496,166513,757787,924300,35626,63791,99417,128846,88676,217522,31356,13870,45226,0.306802116,486414,38961,525375,27059,6890,33949,1,4,813129,505,899294,1712423
States needing Special Attention,Below average state,BIHAR,5-Sep,0,UP,BIHAR,10,B0101,Rural,Underperformance,0.010470625,62673,80050,142723,20454,24975,45429,63989,70859,134848,20174,20944,41118,0.976619936,6426002,6886110,13312112,54140,62312,116452,1,4,6572838,446,7057963,13630801
States needing Special Attention,Below average state,HARYANA,5-Sep,0,UP,HARYANA,6,B0101,Rural,Underperformance,0.004849745,3357,4790,8147,567,783,1350,2435,2910,5345,1338,1651,2989,0.990189192,752280,911121,1663401,3592,4650,8242,1,4,759410,505,920472,1679882
States needing Special Attention,Below average state,BIHAR,50-59,0,UP,BIHAR,10,B0101,Rural,Underperformance,0.427793696,421864,1860853,2282717,182571,408082,590653,423166,616428,1039594,123753,102748,226501,0.334933152,1640486,146725,1787211,111319,25754,137073,1,4,2609269,446,2726754,5336023
States needing Special Attention,Below average state,HARYANA,50-59,0,UP,HARYANA,6,B0101,Rural,Underperformance,0.489395884,87186,428234,515420,15143,28825,43968,68603,47577,116180,19213,8743,27956,0.373745699,343335,50285,393620,10975,3872,14847,1,4,518337,505,534839,1053176
States needing Special Attention,Below average state,BIHAR,60-69,0,UP,BIHAR,10,B0101,Rural,Underperformance,0.35844292,285425,1344801,1630226,107715,277428,385143,276399,496307,772706,93119,106190,199309,0.427837084,1520850,424986,1945836,69286,29581,98867,1,4,2175793,446,2372284,4548077
States needing Special Attention,Below average state,HARYANA,60-69,0,UP,HARYANA,6,B0101,Rural,Underperformance,0.312222581,43435,242993,286428,6535,16054,22589,36710,35831,72541,13835,9847,23682,0.582888954,375029,159704,534733,6244,3692,9936,1,4,469009,505,448375,917384
States needing Special Attention,Below average state,BIHAR,60+,0,UP,BIHAR,10,B0101,Rural,Underperformance,0.328911739,379719,1879308,2259027,134438,367484,501922,356359,693543,1049902,123422,160513,283935,0.476883125,2351235,924087,3275322,87821,43569,131390,1,4,3210735,446,3657451,6868186
States needing Special Attention,Below average state,HARYANA,60+,0,UP,HARYANA,6,B0101,Rural,Underperformance,0.24548563,54783,316610,371393,7858,19816,27674,44499,47325,91824,17620,14689,32309,0.672464176,650924,366441,1017365,8178,5389,13567,1,4,767826,505,745065,1512891
States needing Special Attention,Below average state,BIHAR,70-79,0,UP,BIHAR,10,B0101,Rural,Underperformance,0.290935358,72278,427759,500037,20509,72601,93110,61550,157353,218903,23611,43065,66676,0.542906881,596971,336135,933106,14330,10819,25149,1,4,754410,446,964312,1718722
States needing Special Attention,Below average state,HARYANA,70-79,0,UP,HARYANA,6,B0101,Rural,Underperformance,0.166772364,8437,57832,66269,979,2926,3905,5987,9053,15040,2943,3771,6714,0.778481586,181120,128219,309339,1377,1254,2631,1,4,198487,505,198875,397362
States needing Special Attention,Below average state,BIHAR,80+,0,UP,BIHAR,10,B0101,Rural,Underperformance,0.214111712,22016,106748,128764,6214,17455,23669,18410,39883,58293,6692,11258,17950,0.659109691,233414,162966,396380,4205,3169,7374,1,4,280532,446,320855,601387
States needing Special Attention,Below average state,HARYANA,80+,0,UP,HARYANA,6,B0101,Rural,Underperformance,0.094355144,2911,15785,18696,344,836,1180,1802,2441,4243,842,1071,1913,0.874576699,94775,78518,173293,557,443,1000,1,4,100330,505,97815,198145
States needing Special Attention,Below average state,BIHAR,Age not stated,0,UP,BIHAR,10,B0101,Rural,Underperformance,0.204317742,17130,54182,71312,6704,13550,20254,15909,23987,39896,3300,3697,6997,0.661327985,122139,108681,230820,3963,3625,7588,1,4,158478,446,190547,349025
States needing Special Attention,Below average state,HARYANA,Age not stated,0,UP,HARYANA,6,B0101,Rural,Underperformance,0.218696856,911,3590,4501,222,408,630,714,626,1340,186,122,308,0.701229289,7759,6673,14432,343,284,627,1,4,9570,505,11011,20581
States needing Special Attention,Below average state,BIHAR,Oct-14,0,UP,BIHAR,10,B0101,Rural,Underperformance,0.021534366,93082,175515,268597,48599,87182,135781,121763,163340,285103,60325,68637,128962,0.945268588,5633802,6156483,11790285,98519,137488,236007,1,4,5908972,446,6563975,12472947
States needing Special Attention,Below average state,HARYANA,Oct-14,0,UP,HARYANA,6,B0101,Rural,Underperformance,0.013499671,7526,16947,24473,2971,5386,8357,9295,10796,20091,9134,10123,19257,0.964795387,790818,958220,1749038,8498,13765,22263,1,4,816773,505,996086,1812859
States needing Special Attention,Below average state,BIHAR,Total,0,UP,BIHAR,10,B0101,Rural,Underperformance,0.202768841,3735886,14988080,18723966,1956042,4604091,6560133,4004345,6292958,10297303,1182851,1155647,2338498,0.660393336,35344504,25637165,60981669,2033529,1660514,3694043,1,4,44267586,446,48073850,92341436
States needing Special Attention,Below average state,HARYANA,Total,0,UP,HARYANA,6,B0101,Rural,Underperformance,0.268684266,763217,3672588,4435805,218108,441966,660074,649865,579576,1229441,197816,140050,337866,0.636381279,6124455,4381792,10506247,345754,319751,665505,1,4,7735353,505,8774006,16509359
Not considered,Below average state,INDIA,15-19,0,,,0,B0101,Total,,0.146883196,4981419,12721891,17703310,2335774,4165965,6501739,4127825,5330282,9458107,1409456,1645507,3054963,0.749296688,46025353,44284716,90310069,6711428,8423500,15134928,1,,56544053,558,63982396,120526449
Not considered,Below average state,INDIA,15-59,0,,,0,B0101,Total,,0.444374662,79998486,244427021,324425507,20123842,30683288,50807130,42660037,41944372,84604409,9946430,7975977,17922407,0.415191499,221992936,81126760,303119696,33192058,21861484,55053542,1,,354597889,558,375474130,730072019
Not considered,Below average state,INDIA,20-24,0,,,0,B0101,Total,,0.346999686,9686759,28977411,38664170,3452436,6126314,9578750,6271366,7501893,13773259,1507707,1519224,3026931,0.502223493,36373697,19586165,55959862,8161092,7602474,15763566,1,,53839529,558,57584693,111424222
Not considered,Below average state,INDIA,25-29,0,,,0,B0101,Total,,0.479877678,11764723,36901575,48666298,3310039,5250800,8560839,6442025,6786348,13228373,1419690,1145550,2565240,0.364388218,30443319,6510735,36954054,6076617,3057158,9133775,1,,50069757,558,51344208,101413965
Not considered,Below average state,INDIA,30-34,0,,,0,B0101,Total,,0.532224585,11552088,35600323,47152411,2887138,4069257,6956395,5996977,5475976,11472953,1289016,872943,2161959,0.313873733,25096196,2711432,27807628,3985538,1115810,5101348,1,,43934277,558,44660674,88594951
Not considered,Below average state,INDIA,35-39,0,,,0,B0101,Total,,0.557943262,12131142,35372529,47503671,2719578,3618140,6337718,5865066,5005130,10870196,1240792,794171,2034963,0.290482209,22984303,1747551,24731854,3243539,595714,3839253,1,,42221303,558,42919381,85140684
Not considered,Below average state,INDIA,40-49,0,,,0,B0101,Total,,0.573595173,18898570,58397073,77295643,3646591,4954681,8601272,8799886,7416270,16216156,1861807,1198933,3060740,0.28335492,35512676,2671224,38183900,3557876,652220,4210096,1,,65072939,558,69683500,134756439
Not considered,Below average state,INDIA,5-Sep,0,,,0,B0101,Total,,0.008735716,477933,630875,1108808,150505,178149,328654,512245,554665,1066910,177388,180532,357920,0.980038798,59460094,64934394,124394488,508429,576354,1084783,1,,60627660,558,66300466,126928126
Not considered,Below average state,INDIA,50-59,0,,,0,B0101,Total,,0.537775184,10983785,36456219,47440004,1772286,2498131,4270417,5156892,4428473,9585365,1217962,799649,2017611,0.33069463,25557392,3614937,29172329,1455968,414608,1870576,1,,42916031,558,45299278,88215309
Not considered,Below average state,INDIA,60-69,0,,,0,B0101,Total,,0.371816127,5623759,18216604,23840363,843387,1398142,2241529,2889075,3120663,6009738,875237,750244,1625481,0.509104412,23084544,9558564,32643108,753080,421518,1174598,1,,32472615,558,31646075,64118690
Not considered,Below average state,INDIA,60+,0,,,0,B0101,Total,,0.314004386,7368333,25240721,32609054,1062613,1852858,2915471,3770505,4442635,8213140,1198952,1172196,2371148,0.584075674,40439378,20216320,60655698,1006944,601983,1608927,1,,52777168,558,51071872,103849040
Not considered,Below average state,INDIA,70-79,0,,,0,B0101,Total,,0.243228265,1357408,5560331,6917739,164027,351926,515953,681575,1036324,1717899,255824,327584,583408,0.675857594,12004436,7217863,19222299,185466,133677,319143,1,,14299243,558,14142102,28441345
Not considered,Below average state,INDIA,80+,0,,,0,B0101,Total,,0.163960597,387166,1463786,1850952,55199,102790,157989,199855,285648,485503,67891,94368,162259,0.778659501,5350398,3439893,8790291,68398,46788,115186,1,,6005310,558,5283695,11289005
Not considered,Below average state,INDIA,Age not stated,0,,,0,B0101,Total,,0.262319586,299576,878187,1177763,61573,100859,162432,174065,197600,371665,32861,32251,65112,0.640398396,1610419,1264843,2875262,55138,53118,108256,1,,2116921,558,2372881,4489802
Not considered,Below average state,INDIA,Oct-14,0,,,0,B0101,Total,,0.02444773,1211267,2033172,3244439,536892,726515,1263407,1358015,1450309,2808324,762900,779362,1542262,0.942769421,59958195,65155992,125114187,1276558,1577333,2853891,1,,63290377,558,69418835,132709212
Not considered,Below average state,INDIA,Total,0,,,0,B0101,Total,,0.299429393,89355595,273209976,362565571,21935425,33541669,55477094,48474867,48589581,97064448,12118531,10140318,22258849,0.602025943,437635726,291330383,728966109,36039127,24670272,60709399,1,,587584719,558,623270258,1210854977
Can be easily improved,Below average state,ARUNACHAL PRADESH,15-19,0,UP,ARUNACHAL PRADESH,12,B0101,Total,Underperformance,0.127231227,9031,10813,19844,3204,3203,6407,5328,4943,10271,1853,1783,3636,0.783603047,61083,61134,122217,11442,11588,23030,1,3,77295,563,78673,155968
Can be easily improved,Below average state,WEST BENGAL,15-19,0,UP,WEST BENGAL,19,B0101,Total,Underperformance,0.132115909,222085,974625,1196710,254174,521418,775592,272472,501268,773740,99153,155317,254470,0.754370459,3761996,3071115,6833111,1590126,1450284,3040410,1,3,4355706,560,4702325,9058031
Can be easily improved,Below average state,ARUNACHAL PRADESH,15-59,0,UP,ARUNACHAL PRADESH,12,B0101,Total,Underperformance,0.533761988,163346,277124,440470,20160,19676,39836,42383,33854,76237,8356,6526,14882,0.355819917,180871,112758,293629,39746,30407,70153,1,3,394956,563,430262,825218
Can be easily improved,Below average state,WEST BENGAL,15-59,0,UP,WEST BENGAL,19,B0101,Total,Underperformance,0.401508921,3694510,19867562,23562072,2228793,3485784,5714577,2784856,3621534,6406390,897507,877707,1775214,0.459072654,21051104,5889027,26940131,8469897,3253580,11723477,1,3,28427977,560,30255830,58683807
Can be easily improved,Below average state,ARUNACHAL PRADESH,20-24,0,UP,ARUNACHAL PRADESH,12,B0101,Total,Underperformance,0.388204653,20942,30183,51125,4244,4221,8465,7198,5899,13097,1575,1353,2928,0.490113595,35948,28598,64546,11512,10411,21923,1,3,65663,563,66033,131696
Can be easily improved,Below average state,WEST BENGAL,20-24,0,UP,WEST BENGAL,19,B0101,Total,Underperformance,0.295098764,414214,2170356,2584570,389809,724752,1114561,434285,701157,1135442,138861,167405,306266,0.540291165,3348332,1383712,4732044,1797794,997620,2795414,1,3,4335692,560,4422630,8758322
Can be easily improved,Below average state,ARUNACHAL PRADESH,25-29,0,UP,ARUNACHAL PRADESH,12,B0101,Total,Underperformance,0.597870896,28492,45473,73965,3820,3808,7628,7261,5896,13157,1287,963,2250,0.277591865,23308,11034,34342,7024,4975,11999,1,3,60348,563,63366,123714
Can be easily improved,Below average state,WEST BENGAL,25-29,0,UP,WEST BENGAL,19,B0101,Total,Underperformance,0.41775269,530471,2810677,3341148,380671,594353,975024,438469,591713,1030182,136546,129693,266239,0.420152317,2847519,512821,3360340,1444740,388728,1833468,1,3,3953005,560,4044904,7997909
Can be easily improved,Below average state,ARUNACHAL PRADESH,30-34,0,UP,ARUNACHAL PRADESH,12,B0101,Total,Underperformance,0.680185033,25449,43366,68815,2679,2536,5215,5823,4279,10102,990,698,1688,0.203279596,16447,4119,20566,3712,1601,5313,1,3,48709,563,52462,101171
Can be easily improved,Below average state,WEST BENGAL,30-34,0,UP,WEST BENGAL,19,B0101,Total,Underperformance,0.4740534,526878,2716401,3243279,319355,424852,744207,386153,435033,821186,118375,93575,211950,0.374938428,2345525,219650,2565175,1074850,148066,1222916,1,3,3376931,560,3464659,6841590
Can be easily improved,Below average state,ARUNACHAL PRADESH,35-39,0,UP,ARUNACHAL PRADESH,12,B0101,Total,Underperformance,0.704103145,25110,41351,66461,2299,2113,4412,5325,3946,9271,869,515,1384,0.18301533,14876,2399,17275,2774,777,3551,1,3,46180,563,48211,94391
Can be easily improved,Below average state,WEST BENGAL,35-39,0,UP,WEST BENGAL,19,B0101,Total,Underperformance,0.495016574,584238,2887138,3471376,320317,386221,706538,403959,401785,805744,123587,88611,212198,0.359825378,2377501,145827,2523328,981369,86332,1067701,1,3,3489285,560,3523361,7012646
Can be easily improved,Below average state,ARUNACHAL PRADESH,40-49,0,UP,ARUNACHAL PRADESH,12,B0101,Total,Underperformance,0.7357923,36134,68556,104690,2689,2532,5221,7504,5568,13072,1150,774,1924,0.158811375,19460,3136,22596,2468,738,3206,1,3,64248,563,78034,142282
Can be easily improved,Below average state,WEST BENGAL,40-49,0,UP,WEST BENGAL,19,B0101,Total,Underperformance,0.518126078,915787,5036849,5952636,402601,556834,959435,570706,619239,1189945,180401,143169,323570,0.35013538,3788069,234559,4022628,1151311,105618,1256929,1,3,5454963,560,6033816,11488779
Can be easily improved,Below average state,ARUNACHAL PRADESH,5-Sep,0,UP,ARUNACHAL PRADESH,12,B0101,Total,Underperformance,0.007748812,664,662,1326,433,483,916,1267,1254,2521,435,430,865,0.972464251,82058,84353,166411,1746,1808,3554,1,3,84424,563,86699,171123
Can be easily improved,Below average state,WEST BENGAL,5-Sep,0,UP,WEST BENGAL,19,B0101,Total,Underperformance,0.005535652,19097,26560,45657,12094,13766,25860,23831,25744,49575,6264,6284,12548,0.986932287,3981854,4158175,8140029,86984,93244,180228,1,3,4031046,560,4216763,8247809
Can be easily improved,Below average state,ARUNACHAL PRADESH,50-59,0,UP,ARUNACHAL PRADESH,12,B0101,Total,Underperformance,0.731222696,18188,37382,55570,1225,1263,2488,3944,3323,7267,632,440,1072,0.159047845,9749,2338,12087,814,317,1131,1,3,32513,563,43483,75996
Can be easily improved,Below average state,WEST BENGAL,50-59,0,UP,WEST BENGAL,19,B0101,Total,Underperformance,0.501207462,500837,3271516,3772353,161866,277354,439220,278812,371339,650151,100584,99937,200521,0.385769405,2582162,321343,2903505,429707,76932,506639,1,3,3462395,560,4064135,7526530
Can be easily improved,Below average state,ARUNACHAL PRADESH,60-69,0,UP,ARUNACHAL PRADESH,12,B0101,Total,Underperformance,0.571700727,8288,14819,23107,418,574,992,1812,1800,3612,448,290,738,0.320673957,8736,4225,12961,437,271,708,1,3,19284,563,21134,40418
Can be easily improved,Below average state,WEST BENGAL,60-69,0,UP,WEST BENGAL,19,B0101,Total,Underperformance,0.295546931,177529,1219949,1397478,52799,106358,159157,110587,192260,302847,47877,67256,115133,0.616056181,1994773,918216,2912989,162100,82180,244280,1,3,2330766,560,2397681,4728447
Can be easily improved,Below average state,ARUNACHAL PRADESH,60+,0,UP,ARUNACHAL PRADESH,12,B0101,Total,Underperformance,0.502474897,11148,20829,31977,589,757,1346,2517,2617,5134,693,532,1225,0.397602099,16092,9211,25303,644,427,1071,1,3,30450,563,33189,63639
Can be easily improved,Below average state,WEST BENGAL,60+,0,UP,WEST BENGAL,19,B0101,Total,Underperformance,0.240832472,237798,1626819,1864617,68046,136220,204266,145156,261151,406307,61716,94761,156477,0.686478787,3446398,1868583,5314981,218701,115492,334193,1,3,3891068,560,3851314,7742382
Can be easily improved,Below average state,ARUNACHAL PRADESH,70-79,0,UP,ARUNACHAL PRADESH,12,B0101,Total,Underperformance,0.413762514,2087,4443,6530,115,133,248,499,590,1089,170,183,353,0.494867571,4792,3018,7810,122,95,217,1,3,7548,563,8234,15782
Can be easily improved,Below average state,WEST BENGAL,70-79,0,UP,WEST BENGAL,19,B0101,Total,Underperformance,0.165105282,42668,309068,351736,9325,20572,29897,23559,52112,75671,10275,21768,32043,0.784333643,1006775,664149,1670924,36433,23956,60389,1,3,1083277,560,1047097,2130374
Can be easily improved,Below average state,ARUNACHAL PRADESH,80+,0,UP,ARUNACHAL PRADESH,12,B0101,Total,Underperformance,0.314558408,773,1567,2340,56,50,106,206,227,433,75,59,134,0.60922167,2564,1968,4532,85,61,146,1,3,3618,563,3821,7439
Can be easily improved,Below average state,WEST BENGAL,80+,0,UP,WEST BENGAL,19,B0101,Total,Underperformance,0.130611242,17601,97802,115403,5922,9290,15212,11010,16779,27789,3564,5737,9301,0.827410897,444850,286218,731068,20168,9356,29524,1,3,477025,560,406536,883561
Can be easily improved,Below average state,ARUNACHAL PRADESH,Age not stated,0,UP,ARUNACHAL PRADESH,12,B0101,Total,Underperformance,0.336646786,195,313,508,44,38,82,77,73,150,20,25,45,0.534128562,358,448,806,28,36,64,1,3,650,563,859,1509
Can be easily improved,Below average state,WEST BENGAL,Age not stated,0,UP,WEST BENGAL,19,B0101,Total,Underperformance,0.228241634,4563,21103,25666,2217,2965,5182,3543,4355,7898,730,892,1622,0.68709927,39863,37402,77265,4419,3270,7689,1,3,48699,560,63752,112451
Can be easily improved,Below average state,ARUNACHAL PRADESH,Oct-14,0,UP,ARUNACHAL PRADESH,12,B0101,Total,Underperformance,0.024754821,2259,2181,4440,1076,1061,2137,2719,2544,5263,1305,1309,2614,0.931327672,82637,84405,167042,3580,3633,7213,1,3,88920,563,90439,179359
Can be easily improved,Below average state,WEST BENGAL,Oct-14,0,UP,WEST BENGAL,19,B0101,Total,Underperformance,0.020599304,52383,136235,188618,54813,85811,140624,75041,103083,178124,33313,42257,75570,0.951694328,4318280,4395931,8714211,343291,385668,728959,1,3,4479017,560,4677506,9156523
Can be easily improved,Below average state,ARUNACHAL PRADESH,Total,0,UP,ARUNACHAL PRADESH,12,B0101,Total,Underperformance,0.345964919,177612,301109,478721,22302,22015,44317,48963,40342,89305,10809,8822,19631,0.575308569,432431,363639,796070,45744,36311,82055,1,3,669815,563,713912,1383727
Can be easily improved,Below average state,WEST BENGAL,Total,0,UP,WEST BENGAL,19,B0101,Total,Underperformance,0.281416776,4008351,21678279,25686630,2365963,3724546,6090509,3032427,4015867,7048294,999530,1021901,2021431,0.619217415,36426780,20092980,56519760,9123292,3851254,12974546,1,3,44467088,560,46809027,91276115
Not considered,Below average state,ASSAM,15-19,0,UP,ASSAM,18,B0101,Total,Underperformance,0.136302741,86469,331787,418256,81433,154638,236071,130501,195842,326343,40154,51999,92153,0.727316307,1215968,1015861,2231829,319018,324122,643140,1,4,1473092,516,1595489,3068581
Not considered,Below average state,CHANDIGARH,15-19,0,UP,CHANDIGARH,4,B0101,Total,Underperformance,0.152061905,2365,13513,15878,325,781,1106,583,1222,1805,99,308,407,0.826754008,40850,45478,86328,4229,5694,9923,1,4,43897,538,60521,104418
Not considered,Below average state,DADRA & NAGAR HAVELI,15-19,0,UP,DADRA & NAGAR HAVELI,26,B0101,Total,Underperformance,0.323586274,2212,8500,10712,453,424,877,1303,1151,2454,327,364,691,0.581410101,9283,9964,19247,707,815,1522,1,4,13125,523,19979,33104
Not considered,Below average state,DELHI,15-19,0,UP,DELHI,7,B0101,Total,Underperformance,0.099560687,21478,144527,166005,2622,9295,11917,5436,14744,20180,1044,3859,4903,0.885395907,714299,761988,1476287,41032,82336,123368,1,4,742257,500,925118,1667375
Not considered,Below average state,GOA,15-19,0,UP,GOA,30,B0101,Total,Underperformance,0.128544457,4460,10178,14638,1470,1885,3355,1977,2718,4695,422,808,1230,0.819424808,46941,46371,93312,9993,10029,20022,1,4,53800,535,60075,113875
Not considered,Below average state,JAMMU & KASHMIR,15-19,0,UP,JAMMU & KASHMIR,1,B0101,Total,Underperformance,0.05649224,15882,54025,69907,36464,53040,89504,46967,54824,101791,28564,28064,56628,0.815488476,505687,503449,1009136,129401,140812,270213,1,4,597100,524,640362,1237462
Not considered,Below average state,JHARKHAND,15-19,0,UP,JHARKHAND,20,B0101,Total,Underperformance,0.097535682,95337,217291,312628,127288,209854,337142,191394,238032,429426,86402,87776,174178,0.714148084,1117248,1171788,2289036,149121,214374,363495,1,4,1490381,529,1714887,3205268
Not considered,Below average state,KERALA,15-19,0,UP,KERALA,32,B0101,Total,Underperformance,0.04880079,26451,100946,127397,19203,34750,53953,22087,38852,60939,3365,9480,12845,0.922935456,1230350,1179021,2409371,371706,373120,744826,1,4,1282253,539,1328299,2610552
Not considered,Below average state,LAKSHADWEEP,15-19,0,UP,LAKSHADWEEP,31,B0101,Total,Underperformance,0.009957326,11,45,56,51,124,175,40,96,136,17,48,65,0.954302987,2748,2619,5367,1153,1120,2273,1,4,2816,528,2808,5624
Not considered,Below average state,MADHYA PRADESH,15-19,0,UP,MADHYA PRADESH,23,B0101,Total,Underperformance,0.17713581,414179,904914,1319093,222689,336210,558899,385700,418764,804464,129149,133078,262227,0.679622452,2537689,2523316,5061005,256825,360413,617238,1,3,3466717,554,3980072,7446789
Not considered,Below average state,MANIPUR,15-19,0,UP,MANIPUR,14,B0101,Total,Underperformance,0.120024529,15274,19174,34448,8898,8482,17380,12456,10311,22767,5607,4907,10514,0.764017031,109176,110103,219279,26375,28246,54621,1,3,142513,551,144495,287008
Not considered,Below average state,NAGALAND,15-19,0,UP,NAGALAND,13,B0101,Total,Underperformance,0.160698888,16240,20660,36900,6708,7889,14597,11072,11642,22714,12281,12843,25124,0.630967416,72035,72849,144884,11839,12465,24304,1,3,111628,567,117994,229622
Not considered,Below average state,ODISHA,15-19,0,UP,ODISHA,21,B0101,Total,Underperformance,0.11541301,120469,332573,453042,213130,281014,494144,285450,314386,599836,89110,83986,173096,0.687681606,1457685,1241739,2699424,327741,392206,719947,1,3,1952714,558,1972684,3925398
Not considered,Below average state,PUDUCHERRY,15-19,0,UP,PUDUCHERRY,34,B0101,Total,Underperformance,0.077153133,2284,5610,7894,351,619,970,520,937,1457,128,217,345,0.905234763,47153,45467,92620,5189,5906,11095,1,4,50085,493,52231,102316
Not considered,Below average state,PUNJAB,15-19,0,UP,PUNJAB,3,B0101,Total,Underperformance,0.140634344,58222,338041,396263,28583,63393,91976,43878,82205,126083,13882,22293,36175,0.801780044,1131521,1127641,2259162,158942,229756,388698,1,3,1247503,556,1570180,2817683
Not considered,Below average state,UTTAR PRADESH,15-19,0,UP,UTTAR PRADESH,9,B0101,Total,Underperformance,0.112654956,473651,2121962,2595613,284665,867583,1152248,611981,1180328,1792309,232923,339612,572535,0.784705938,9414252,8665671,18079923,934859,1528800,2463659,1,4,10732807,507,12307573,23040380
Not considered,Below average state,UTTARAKHAND,15-19,0,UP,UTTARAKHAND,5,B0101,Total,Underperformance,0.111061195,33672,91173,124845,17612,30170,47782,29736,36674,66410,19323,19315,38638,0.795488876,452896,441321,894217,45820,67108,112928,1,4,535627,544,588483,1124110
Not considered,Below average state,ASSAM,15-59,0,UP,ASSAM,18,B0101,Total,Underperformance,0.416854191,1512767,6348815,7861582,597522,808187,1405709,1313211,1107798,2421009,285305,208583,493888,0.428585692,6103943,1978887,8082830,1497997,840703,2338700,1,4,9215226,516,9644083,18859309
Not considered,Below average state,CHANDIGARH,15-59,0,UP,CHANDIGARH,4,B0101,Total,Underperformance,0.51258742,65782,304057,369839,2636,4816,7452,5399,7992,13391,1033,1756,2789,0.464987512,248413,87082,335495,27771,17984,45755,1,4,320627,538,400887,721514
Not considered,Below average state,DADRA & NAGAR HAVELI,15-59,0,UP,DADRA & NAGAR HAVELI,26,B0101,Total,Underperformance,0.563551292,19880,105021,124901,2452,2550,5002,13338,7686,21024,1815,1548,3363,0.326414958,55744,16600,72344,4373,2212,6585,1,4,90777,523,130855,221632
Not considered,Below average state,DELHI,15-59,0,UP,DELHI,7,B0101,Total,Underperformance,0.454655818,706846,4320954,5027800,26319,86326,112645,60803,152441,213244,10975,29417,40392,0.522408289,4337724,1439315,5777039,296358,302724,599082,1,4,5116348,500,5942127,11058475
Not considered,Below average state,GOA,15-59,0,UP,GOA,30,B0101,Total,Underperformance,0.452114083,108931,331788,440719,15644,27288,42932,26964,44972,71936,7157,10913,18070,0.455552752,332123,111948,444071,71193,38896,110089,1,4,475175,535,499621,974796
Not considered,Below average state,JAMMU & KASHMIR,15-59,0,UP,JAMMU & KASHMIR,1,B0101,Total,Underperformance,0.329213533,310628,2113311,2423939,271214,494737,765951,467678,583683,1051361,227914,170723,398637,0.473851245,2463436,1025444,3488880,621523,391349,1012872,1,4,3469656,524,3893161,7362817
Not considered,Below average state,JHARKHAND,15-59,0,UP,JHARKHAND,20,B0101,Total,Underperformance,0.330225664,1424662,4725330,6149992,1227796,1969874,3197670,2061792,2324175,4385967,639219,414278,1053497,0.377700686,4913253,2120895,7034148,719862,601379,1321241,1,4,9038926,529,9584678,18623604
Not considered,Below average state,KERALA,15-59,0,UP,KERALA,32,B0101,Total,Underperformance,0.399311095,1998339,6525838,8524177,457940,606587,1064527,689988,929402,1619390,223492,173928,397420,0.506212381,8298510,2507711,10806221,2659795,1063326,3723121,1,4,11210329,539,10136879,21347208
Not considered,Below average state,LAKSHADWEEP,15-59,0,UP,LAKSHADWEEP,31,B0101,Total,Underperformance,0.2448453,1629,8809,10438,1428,4687,6115,1048,4041,5089,662,1813,2475,0.57772513,17179,7450,24629,7026,4722,11748,1,4,20518,528,22113,42631
Not considered,Below average state,MADHYA PRADESH,15-59,0,UP,MADHYA PRADESH,23,B0101,Total,Underperformance,0.47952858,5704088,14689490,20393578,1892834,2215814,4108648,3712847,2770938,6483785,738141,485999,1224140,0.339229544,10197208,4229678,14426886,1156638,934746,2091384,1,3,20352284,554,22176105,42528389
Not considered,Below average state,MANIPUR,15-59,0,UP,MANIPUR,14,B0101,Total,Underperformance,0.488431733,322429,550061,872490,72714,57326,130040,143310,82848,226158,37470,19986,57456,0.352797304,392613,237592,630205,107440,85419,192859,1,3,895822,551,890487,1786309
Not considered,Below average state,NAGALAND,15-59,0,UP,NAGALAND,13,B0101,Total,Underperformance,0.558208041,268138,399073,667211,30977,31572,62549,67836,48362,116198,28693,25175,53868,0.299509819,212760,145236,357996,45742,40686,86428,1,3,577427,567,617846,1195273
Not considered,Below average state,ODISHA,15-59,0,UP,ODISHA,21,B0101,Total,Underperformance,0.373441262,1739908,7892702,9632610,1585573,1877205,3462778,2698496,2289233,4987729,629841,395845,1025686,0.393428021,7736414,2411738,10148152,1416777,1011069,2427846,1,3,12804659,558,12989518,25794177
Not considered,Below average state,PUDUCHERRY,15-59,0,UP,PUDUCHERRY,34,B0101,Total,Underperformance,0.45413418,87811,288223,376034,6047,9982,16029,13049,19132,32181,3885,4485,8370,0.496892602,316713,94726,411439,42096,23607,65703,1,4,421458,493,406566,828024
Not considered,Below average state,PUNJAB,15-59,0,UP,PUNJAB,3,B0101,Total,Underperformance,0.424636369,1065349,6472392,7537741,216741,386920,603661,413755,558264,972019,129090,124619,253709,0.506312613,6866492,2121088,8987580,864712,554655,1419367,1,3,8474686,556,9276363,17751049
Not considered,Below average state,UTTAR PRADESH,15-59,0,UP,UTTAR PRADESH,9,B0101,Total,Underperformance,0.342018061,6044441,32070773,38115214,2243214,6121195,8364409,5625363,8590971,14216334,1647706,1813261,3460967,0.499358766,40137114,15512480,55649594,3835533,3732656,7568189,1,4,53454624,507,57987485,111442109
Not considered,Below average state,UTTARAKHAND,15-59,0,UP,UTTARAKHAND,5,B0101,Total,Underperformance,0.424511003,707846,1856144,2563990,154435,252928,407363,330476,315997,646473,102822,79092,181914,0.438335811,1864600,782890,2647490,209095,191936,401031,1,4,3005744,544,3034123,6039867
Not considered,Below average state,ASSAM,20-24,0,UP,ASSAM,18,B0101,Total,Underperformance,0.285902444,174801,657005,831806,123373,193392,316765,214423,234894,449317,49311,45710,95021,0.527001569,1055290,477971,1533261,371168,270513,641681,1,4,1493825,516,1415580,2909405
Not considered,Below average state,CHANDIGARH,20-24,0,UP,CHANDIGARH,4,B0101,Total,Underperformance,0.377626934,6873,38912,45785,751,1442,2193,1066,2014,3080,246,501,747,0.590808617,44592,27040,71632,8592,7909,16501,1,4,52777,538,68467,121244
Not considered,Below average state,DADRA & NAGAR HAVELI,20-24,0,UP,DADRA & NAGAR HAVELI,26,B0101,Total,Underperformance,0.557572064,3285,21416,24701,534,643,1177,2425,1943,4368,315,356,671,0.328683325,10681,3880,14561,1247,855,2102,1,4,16706,523,27595,44301
Not considered,Below average state,DELHI,20-24,0,UP,DELHI,7,B0101,Total,Underperformance,0.327001349,82410,494440,576850,6027,20587,26614,10798,30632,41430,2080,7210,9290,0.644246794,717361,419129,1136490,92809,128893,221702,1,4,812649,500,951411,1764060
Not considered,Below average state,GOA,20-24,0,UP,GOA,30,B0101,Total,Underperformance,0.401162568,15059,37391,52450,3198,5226,8424,4114,6866,10980,952,1866,2818,0.493303759,40004,24493,64497,15393,12316,27709,1,4,60129,535,70616,130745
Not considered,Below average state,JAMMU & KASHMIR,20-24,0,UP,JAMMU & KASHMIR,1,B0101,Total,Underperformance,0.207524595,34765,206153,240918,55864,92570,148434,74460,95161,169621,36616,31750,68366,0.587475547,411494,270514,682008,159630,137793,297423,1,4,557335,524,603578,1160913
Not considered,Below average state,JHARKHAND,20-24,0,UP,JHARKHAND,20,B0101,Total,Underperformance,0.236923818,178395,491536,669931,204450,325884,530334,316167,358506,674673,101839,73053,174892,0.462624071,799958,508168,1308126,174203,202501,376704,1,4,1396359,529,1431263,2827622
Not considered,Below average state,KERALA,20-24,0,UP,KERALA,32,B0101,Total,Underperformance,0.247553369,129176,530754,659930,57385,114536,171921,60228,122877,183105,13267,27462,40729,0.668481875,1164312,617733,1782045,626041,407614,1033655,1,4,1366983,539,1298826,2665809
Not considered,Below average state,LAKSHADWEEP,20-24,0,UP,LAKSHADWEEP,31,B0101,Total,Underperformance,0.081145994,69,404,473,220,726,946,145,525,670,92,297,389,0.737176188,2452,1845,4297,1715,1492,3207,1,4,2758,528,3071,5829
Not considered,Below average state,MADHYA PRADESH,20-24,0,UP,MADHYA PRADESH,23,B0101,Total,Underperformance,0.393632687,735727,1912468,2648195,323116,472786,795902,580293,558615,1138908,123599,102649,226248,0.403447957,1733872,980356,2714228,305328,335922,641250,1,3,3173491,554,3554088,6727579
Not considered,Below average state,MANIPUR,20-24,0,UP,MANIPUR,14,B0101,Total,Underperformance,0.330202071,37230,55815,93045,14803,13319,28122,22170,15692,37862,6812,4593,11405,0.494957094,75983,63487,139470,28870,28911,57781,1,3,142195,551,139587,281782
Not considered,Below average state,NAGALAND,20-24,0,UP,NAGALAND,13,B0101,Total,Underperformance,0.387301028,33583,45567,79150,8589,9586,18175,12647,11745,24392,6651,6500,13151,0.428991549,47713,39957,87670,15073,14833,29906,1,3,100594,567,103769,204363
Not considered,Below average state,ODISHA,20-24,0,UP,ODISHA,21,B0101,Total,Underperformance,0.258183436,199255,777589,976844,261281,382108,643389,385582,424118,809700,93536,79502,173038,0.482075323,1234215,589730,1823945,353891,342288,696179,1,3,1912588,558,1870939,3783527
Not considered,Below average state,PUDUCHERRY,20-24,0,UP,PUDUCHERRY,34,B0101,Total,Underperformance,0.29243055,9029,22793,31822,1026,1787,2813,1452,2395,3847,374,562,936,0.663615729,46677,25537,72214,11281,9782,21063,1,4,57532,493,51287,108819
Not considered,Below average state,PUNJAB,20-24,0,UP,PUNJAB,3,B0101,Total,Underperformance,0.340606763,124537,821204,945741,40807,89381,130188,63377,113405,176782,18680,26326,45006,0.579516725,1104511,504596,1609107,225558,194091,419649,1,3,1311105,556,1465531,2776636
Not considered,Below average state,UTTAR PRADESH,20-24,0,UP,UTTAR PRADESH,9,B0101,Total,Underperformance,0.267242794,696411,4001356,4697767,348931,1170158,1519089,770865,1509826,2280691,226346,323173,549519,0.571754494,6479541,3571130,10050671,887061,1184117,2071178,1,4,8173163,507,9405485,17578648
Not considered,Below average state,UTTARAKHAND,20-24,0,UP,UTTARAKHAND,5,B0101,Total,Underperformance,0.319568319,90483,219520,310003,32326,50639,82965,52911,55346,108257,17022,15522,32544,0.535286186,325038,194226,519264,63021,73301,136322,1,4,485454,544,484614,970068
Not considered,Below average state,ASSAM,25-29,0,UP,ASSAM,18,B0101,Total,Underperformance,0.417827559,231560,944686,1176246,119416,159793,279209,230380,204880,435260,47421,34193,81614,0.398567819,912744,209283,1122027,287433,131630,419063,1,4,1422105,516,1393042,2815147
Not considered,Below average state,CHANDIGARH,25-29,0,UP,CHANDIGARH,4,B0101,Total,Underperformance,0.577682629,11238,52444,63682,564,961,1525,970,1519,2489,188,307,495,0.395248419,37147,6424,43571,6667,2774,9441,1,4,49543,538,60694,110237
Not considered,Below average state,DADRA & NAGAR HAVELI,25-29,0,UP,DADRA & NAGAR HAVELI,26,B0101,Total,Underperformance,0.603384731,3209,20857,24066,404,512,916,2228,1399,3627,261,265,526,0.292490911,10691,975,11666,1024,271,1295,1,4,16389,523,23496,39885
Not considered,Below average state,DELHI,25-29,0,UP,DELHI,7,B0101,Total,Underperformance,0.512894362,124081,731594,855675,5044,16631,21675,10324,28283,38607,1735,5398,7133,0.459688934,653990,112921,766911,67460,51849,119309,1,4,790130,500,878196,1668326
Not considered,Below average state,GOA,25-29,0,UP,GOA,30,B0101,Total,Underperformance,0.50622804,18486,48653,67139,2953,5145,8098,4195,7236,11431,928,1698,2626,0.387782184,41273,10157,51430,13821,6126,19947,1,4,64882,535,67744,132626
Not considered,Below average state,JAMMU & KASHMIR,25-29,0,UP,JAMMU & KASHMIR,1,B0101,Total,Underperformance,0.375283808,51394,356210,407604,50373,87118,137491,76862,96849,173711,35466,25532,60998,0.408618001,337841,105968,443809,119265,62944,182209,1,4,501563,524,584559,1086122
Not considered,Below average state,JHARKHAND,25-29,0,UP,JHARKHAND,20,B0101,Total,Underperformance,0.344715206,212778,701627,914405,203813,337944,541757,325777,385005,710782,98648,60854,159502,0.327202458,673122,194828,867950,131587,99063,230650,1,4,1310325,529,1342314,2652639
Not considered,Below average state,KERALA,25-29,0,UP,KERALA,32,B0101,Total,Underperformance,0.41393046,214338,863575,1077913,68990,114510,183500,76258,137396,213654,20515,24779,45294,0.486630657,1089003,178228,1267231,539633,130128,669761,1,4,1400114,539,1203978,2604092
Not considered,Below average state,LAKSHADWEEP,25-29,0,UP,LAKSHADWEEP,31,B0101,Total,Underperformance,0.184347243,212,888,1100,342,1014,1356,238,792,1030,135,360,495,0.560080442,2247,1095,3342,1340,928,2268,1,4,2832,528,3135,5967
Not considered,Below average state,MADHYA PRADESH,25-29,0,UP,MADHYA PRADESH,23,B0101,Total,Underperformance,0.516395836,808180,2180464,2988644,293922,366939,660861,555560,446452,1002012,103332,65342,168674,0.281326015,1332109,296067,1628176,203744,130871,334615,1,3,2799181,554,2988325,5787506
Not considered,Below average state,MANIPUR,25-29,0,UP,MANIPUR,14,B0101,Total,Underperformance,0.498312241,50090,84692,134782,15140,11855,26995,25335,15290,40625,6502,3233,9735,0.315498175,55662,29673,85335,21125,15759,36884,1,3,137589,551,132888,270477
Not considered,Below average state,NAGALAND,25-29,0,UP,NAGALAND,13,B0101,Total,Underperformance,0.589041328,42522,61680,104202,6494,6485,12979,11651,8574,20225,3546,2869,6415,0.260365967,29584,16475,46059,9773,8514,18287,1,3,87303,567,89598,176901
Not considered,Below average state,ODISHA,25-29,0,UP,ODISHA,21,B0101,Total,Underperformance,0.375876355,241166,1102230,1343396,245082,323901,568983,388943,374171,763114,87006,57852,144858,0.370077031,1084046,238623,1322669,252433,156236,408669,1,3,1801161,558,1772876,3574037
Not considered,Below average state,PUDUCHERRY,25-29,0,UP,PUDUCHERRY,34,B0101,Total,Underperformance,0.472150807,13026,42803,55829,1160,2029,3189,1946,3097,5043,503,643,1146,0.475508271,47717,8509,56226,10256,4525,14781,1,4,63192,493,55052,118244
Not considered,Below average state,PUNJAB,25-29,0,UP,PUNJAB,3,B0101,Total,Underperformance,0.473513725,163650,1003022,1166672,34728,64970,99698,60742,89830,150572,18250,19166,37416,0.45018814,950814,158387,1109201,164630,66581,231211,1,3,1193456,556,1270405,2463861
Not considered,Below average state,UTTAR PRADESH,25-29,0,UP,UTTAR PRADESH,9,B0101,Total,Underperformance,0.372535439,832455,4599048,5431503,341554,1001389,1342943,804494,1346423,2150917,228398,263181,491579,0.446221283,5248115,1257715,6505830,618594,477739,1096333,1,4,7113462,507,7466367,14579829
Not considered,Below average state,UTTARAKHAND,25-29,0,UP,UTTARAKHAND,5,B0101,Total,Underperformance,0.474595894,104361,280149,384510,26486,43503,69989,49578,50305,99883,13330,10642,23972,0.372531425,245552,56267,301819,41127,28033,69160,1,4,412821,544,397363,810184
Not considered,Below average state,ASSAM,30-34,0,UP,ASSAM,18,B0101,Total,Underperformance,0.490467627,222646,920173,1142819,86313,102466,188779,188890,138593,327483,37354,21956,59310,0.343531068,706923,93525,800448,185324,55058,240382,1,4,1155813,516,1174247,2330060
Not considered,Below average state,CHANDIGARH,30-34,0,UP,CHANDIGARH,4,B0101,Total,Underperformance,0.624880235,9957,46784,56741,332,548,880,774,961,1735,148,178,326,0.352422277,30299,1702,32001,3338,696,4034,1,4,41178,538,49625,90803
Not considered,Below average state,DADRA & NAGAR HAVELI,30-34,0,UP,DADRA & NAGAR HAVELI,26,B0101,Total,Underperformance,0.635749486,2922,16558,19480,318,269,587,1837,879,2716,209,146,355,0.264025326,7716,374,8090,580,86,666,1,4,12684,523,17957,30641
Not considered,Below average state,DELHI,30-34,0,UP,DELHI,7,B0101,Total,Underperformance,0.560631185,106721,697616,804337,3780,11621,15401,8668,21025,29693,1597,3521,5118,0.415105189,560258,35293,595551,37802,16216,54018,1,4,677244,500,757455,1434699
Not considered,Below average state,GOA,30-34,0,UP,GOA,30,B0101,Total,Underperformance,0.514448708,15332,49416,64748,2208,4164,6372,3518,6525,10043,891,1398,2289,0.387568628,42647,6132,48779,11196,3440,14636,1,4,62388,535,63471,125859
Not considered,Below average state,JAMMU & KASHMIR,30-34,0,UP,JAMMU & KASHMIR,1,B0101,Total,Underperformance,0.431130334,51767,347849,399616,38989,72731,111720,67338,84427,151765,31133,20831,51964,0.349074283,280919,42639,323558,75109,22875,97984,1,4,431157,524,495746,926903
Not considered,Below average state,JHARKHAND,30-34,0,UP,JHARKHAND,20,B0101,Total,Underperformance,0.398332507,208757,710314,919071,180439,285047,465486,295890,329245,625135,85302,47256,132558,0.273277464,551481,79051,630532,87836,39577,127413,1,4,1141430,529,1165866,2307296
Not considered,Below average state,KERALA,30-34,0,UP,KERALA,32,B0101,Total,Underperformance,0.479553053,262393,915150,1177543,72514,85401,157915,89189,118621,207810,29422,19367,48789,0.415947295,946280,75079,1021359,389398,44540,433938,1,4,1327284,539,1128217,2455501
Not considered,Below average state,LAKSHADWEEP,30-34,0,UP,LAKSHADWEEP,31,B0101,Total,Underperformance,0.24517197,243,1090,1333,294,930,1224,202,739,941,135,365,500,0.489792165,2080,583,2663,1022,457,1479,1,4,2660,528,2777,5437
Not considered,Below average state,MADHYA PRADESH,30-34,0,UP,MADHYA PRADESH,23,B0101,Total,Underperformance,0.569954324,839326,2132963,2972289,274130,286523,560653,531780,353291,885071,93066,47526,140592,0.233368616,1100083,116925,1217008,131266,45377,176643,1,3,2564255,554,2650705,5214960
Not considered,Below average state,MANIPUR,30-34,0,UP,MANIPUR,14,B0101,Total,Underperformance,0.587941381,46326,83582,129908,10575,8076,18651,20681,11469,32150,4756,2073,6829,0.235646334,39513,12554,52067,12199,6594,18793,1,3,111276,551,109678,220954
Not considered,Below average state,NAGALAND,30-34,0,UP,NAGALAND,13,B0101,Total,Underperformance,0.705337371,41994,63753,105747,3790,3534,7324,9484,5521,15005,2058,1216,3274,0.172740855,19883,6015,25898,4599,2938,7537,1,3,73419,567,76505,149924
Not considered,Below average state,ODISHA,30-34,0,UP,ODISHA,21,B0101,Total,Underperformance,0.442946499,242973,1131486,1374459,212350,230680,443030,358530,277086,635616,77421,40194,117615,0.314309967,881834,93467,975301,160964,54967,215931,1,3,1560758,558,1542233,3102991
Not considered,Below average state,PUDUCHERRY,30-34,0,UP,PUDUCHERRY,34,B0101,Total,Underperformance,0.545304763,13649,46918,60567,973,1623,2596,1929,2951,4880,547,625,1172,0.400207077,41184,3267,44451,6535,1515,8050,1,4,57309,493,53761,111070
Not considered,Below average state,PUNJAB,30-34,0,UP,PUNJAB,3,B0101,Total,Underperformance,0.513859655,158184,929420,1087604,29729,45331,75060,56568,67675,124243,18094,13893,31987,0.412326444,801160,71545,872705,99581,22381,121962,1,3,1034006,556,1082533,2116539
Not considered,Below average state,UTTAR PRADESH,30-34,0,UP,UTTAR PRADESH,9,B0101,Total,Underperformance,0.411751906,864123,4469992,5334115,325537,819698,1145235,804188,1129233,1933421,226740,215675,442415,0.404852161,4628230,616501,5244731,429686,214671,644357,1,4,6523281,507,6431401,12954682
Not considered,Below average state,UTTARAKHAND,30-34,0,UP,UTTARAKHAND,5,B0101,Total,Underperformance,0.537544036,100141,275226,375367,20663,34548,55211,42925,41680,84605,10980,7918,18898,0.31423457,198827,20603,219430,22892,9567,32459,1,4,352873,544,345427,698300
Not considered,Below average state,ASSAM,35-39,0,UP,ASSAM,18,B0101,Total,Underperformance,0.532926958,235767,968900,1204667,75077,78852,153929,179778,112938,292716,34999,17858,52857,0.314196631,656250,53983,710233,148288,27998,176286,1,4,1106794,516,1153679,2260473
Not considered,Below average state,CHANDIGARH,35-39,0,UP,CHANDIGARH,4,B0101,Total,Underperformance,0.64330959,10025,43802,53827,278,400,678,714,696,1410,152,154,306,0.336181757,27215,914,28129,2519,299,2818,1,4,38106,538,45566,83672
Not considered,Below average state,DADRA & NAGAR HAVELI,35-39,0,UP,DADRA & NAGAR HAVELI,26,B0101,Total,Underperformance,0.652371721,2722,13768,16490,261,213,474,1673,694,2367,184,109,293,0.242394271,5836,291,6127,373,60,433,1,4,10415,523,14862,25277
Not considered,Below average state,DELHI,35-39,0,UP,DELHI,7,B0101,Total,Underperformance,0.579916983,107392,657660,765052,3536,9918,13454,8573,18266,26839,1649,2985,4634,0.396226172,503175,19544,522719,26232,7517,33749,1,4,620789,500,698455,1319244
Not considered,Below average state,GOA,35-39,0,UP,GOA,30,B0101,Total,Underperformance,0.52163138,14845,51036,65881,2176,3876,6052,3764,6235,9999,1040,1390,2430,0.379958511,43108,4880,47988,9527,2400,11927,1,4,62757,535,63541,126298
Not considered,Below average state,JAMMU & KASHMIR,35-39,0,UP,JAMMU & KASHMIR,1,B0101,Total,Underperformance,0.447263245,49235,325547,374782,32291,62069,94360,61417,74925,136342,28155,18143,46298,0.334774955,257873,22650,280523,56231,9987,66218,1,4,396680,524,441265,837945
Not considered,Below average state,JHARKHAND,35-39,0,UP,JHARKHAND,20,B0101,Total,Underperformance,0.428018724,206968,707607,914575,163122,254566,417688,272616,299620,572236,76555,41445,118000,0.248952622,487950,44003,531953,67430,18643,86073,1,4,1044089,529,1092675,2136764
Not considered,Below average state,KERALA,35-39,0,UP,KERALA,32,B0101,Total,Underperformance,0.513925215,356217,969542,1325759,85008,77730,162738,115442,116886,232328,39506,18890,58396,0.373376781,906689,56501,963190,312462,27919,340381,1,4,1417854,539,1161819,2579673
Not considered,Below average state,LAKSHADWEEP,35-39,0,UP,LAKSHADWEEP,31,B0101,Total,Underperformance,0.286323993,276,1267,1543,262,818,1080,191,731,922,130,302,432,0.462423455,2036,456,2492,770,327,1097,1,4,2633,528,2756,5389
Not considered,Below average state,MADHYA PRADESH,35-39,0,UP,MADHYA PRADESH,23,B0101,Total,Underperformance,0.596761278,832880,2068377,2901257,249679,247798,497477,494176,310683,804859,83243,41166,124409,0.212097034,957908,73238,1031146,96868,22210,119078,1,3,2368207,554,2493464,4861671
Not considered,Below average state,MANIPUR,35-39,0,UP,MANIPUR,14,B0101,Total,Underperformance,0.631958197,44784,80630,125414,8501,5874,14375,18706,9230,27936,4081,1620,5701,0.198545751,32863,6539,39402,8403,2894,11297,1,3,100434,551,98019,198453
Not considered,Below average state,NAGALAND,35-39,0,UP,NAGALAND,13,B0101,Total,Underperformance,0.755589011,39301,57564,96865,2530,1814,4344,7769,3655,11424,1522,678,2200,0.13813788,14911,2798,17709,2311,1054,3365,1,3,63503,567,64695,128198
Not considered,Below average state,ODISHA,35-39,0,UP,ODISHA,21,B0101,Total,Underperformance,0.475226699,263288,1186718,1450006,208702,205812,414514,366304,253906,620210,77032,36035,113067,0.284448221,815879,52026,867905,125163,24393,149556,1,3,1522503,558,1528685,3051188
Not considered,Below average state,PUDUCHERRY,35-39,0,UP,PUDUCHERRY,34,B0101,Total,Underperformance,0.580751729,15116,47291,62407,991,1398,2389,2236,2701,4937,657,639,1296,0.361244754,36795,2024,38819,4387,698,5085,1,4,54804,493,52655,107459
Not considered,Below average state,PUNJAB,35-39,0,UP,PUNJAB,3,B0101,Total,Underperformance,0.527020906,160431,887851,1048282,27852,38717,66569,55586,59371,114957,18097,12085,30182,0.400010859,744095,51555,795650,78720,12571,91291,1,3,978209,556,1010862,1989071
Not considered,Below average state,UTTAR PRADESH,35-39,0,UP,UTTAR PRADESH,9,B0101,Total,Underperformance,0.446076853,902540,4698500,5601040,309473,764037,1073510,789648,1077414,1867062,218495,205203,423698,0.371482919,4244308,420114,4664422,354905,127998,482903,1,4,6154991,507,6401231,12556222
Not considered,Below average state,UTTARAKHAND,35-39,0,UP,UTTARAKHAND,5,B0101,Total,Underperformance,0.563529677,102943,272086,375029,18440,31186,49626,41494,39001,80495,10690,7147,17837,0.288713749,179539,12600,192139,15704,4572,20276,1,4,334666,544,330834,665500
Not considered,Below average state,ASSAM,40-49,0,UP,ASSAM,18,B0101,Total,Underperformance,0.569034177,370120,1579650,1949770,81381,85185,166566,245748,144255,390003,48773,23418,72191,0.296075974,950270,64221,1014491,139702,21969,161671,1,4,1614911,516,1811544,3426455
Not considered,Below average state,CHANDIGARH,40-49,0,UP,CHANDIGARH,4,B0101,Total,Underperformance,0.645154054,16121,67280,83401,298,498,796,905,1038,1943,152,203,355,0.337069612,41934,1640,43574,1928,338,2266,1,4,59112,538,70161,129273
Not considered,Below average state,DADRA & NAGAR HAVELI,40-49,0,UP,DADRA & NAGAR HAVELI,26,B0101,Total,Underperformance,0.633218642,3705,16539,20244,341,329,670,2550,1023,3573,313,164,477,0.240100094,7177,499,7676,337,90,427,1,4,13745,523,18225,31970
Not considered,Below average state,DELHI,40-49,0,UP,DELHI,7,B0101,Total,Underperformance,0.593341499,169430,1022243,1191673,3939,13006,16945,11690,26554,38244,1984,4227,6211,0.384524076,739221,33061,772282,24184,9251,33435,1,4,922325,500,1086085,2008410
Not considered,Below average state,GOA,40-49,0,UP,GOA,30,B0101,Total,Underperformance,0.533948674,25300,83224,108524,2689,4981,7670,5845,9643,15488,1790,2300,4090,0.369725655,66942,8204,75146,8659,2901,11560,1,4,99877,535,103371,203248
Not considered,Below average state,JAMMU & KASHMIR,40-49,0,UP,JAMMU & KASHMIR,1,B0101,Total,Underperformance,0.458083724,71824,525918,597742,40146,84557,124703,90928,111504,202432,43148,27766,70914,0.332435674,399676,34111,433787,59313,9940,69253,1,4,605576,524,699299,1304875
Not considered,Below average state,JHARKHAND,40-49,0,UP,JHARKHAND,20,B0101,Total,Underperformance,0.44801541,327389,1161187,1488576,231763,365904,597667,415312,449948,865260,115042,62099,177141,0.238254078,735470,56153,791623,75464,17241,92705,1,4,1593213,529,1729387,3322600
Not considered,Below average state,KERALA,40-49,0,UP,KERALA,32,B0101,Total,Underperformance,0.523178398,650214,1840653,2490867,111852,117936,229788,205339,220899,426238,72006,38032,110038,0.364182903,1610447,123438,1733885,321317,42672,363989,1,4,2538006,539,2223022,4761028
Not considered,Below average state,LAKSHADWEEP,40-49,0,UP,LAKSHADWEEP,31,B0101,Total,Underperformance,0.391185555,466,2827,3293,200,833,1033,166,815,981,103,333,436,0.440484676,3255,453,3708,801,250,1051,1,4,3990,528,4428,8418
Not considered,Below average state,MADHYA PRADESH,40-49,0,UP,MADHYA PRADESH,23,B0101,Total,Underperformance,0.613951523,1331053,3419357,4750410,356773,339929,696702,748283,442776,1191059,124932,59672,184604,0.20825532,1500481,110881,1611362,112370,24571,136941,1,3,3704749,554,4032686,7737435
Not considered,Below average state,MANIPUR,40-49,0,UP,MANIPUR,14,B0101,Total,Underperformance,0.676098522,78174,136730,214904,9780,6639,16419,27417,12874,40291,5838,2139,7977,0.172047984,46617,8070,54687,7354,2123,9477,1,3,158046,551,159813,317859
Not considered,Below average state,NAGALAND,40-49,0,UP,NAGALAND,13,B0101,Total,Underperformance,0.803099367,61324,96893,158217,2075,1647,3722,10131,4649,14780,1729,644,2373,0.109833103,18414,3224,21638,1631,618,2249,1,3,91598,567,105410,197008
Not considered,Below average state,ODISHA,40-49,0,UP,ODISHA,21,B0101,Total,Underperformance,0.497501743,437209,2062988,2500197,301121,300457,601578,579411,400335,979746,123431,57752,181183,0.27149078,1285167,79211,1364378,135971,25308,161279,1,3,2425218,558,2600286,5025504
Not considered,Below average state,PUDUCHERRY,40-49,0,UP,PUDUCHERRY,34,B0101,Total,Underperformance,0.590682738,22638,77237,99875,1135,1776,2911,3245,4354,7599,1045,1076,2121,0.351831043,56049,3440,59489,3445,732,4177,1,4,82977,493,86107,169084
Not considered,Below average state,PUNJAB,40-49,0,UP,PUNJAB,3,B0101,Total,Underperformance,0.527983496,258365,1524234,1782599,38484,56630,95114,87538,92660,180198,27782,19113,46895,0.404754401,1275212,91336,1366548,96455,17333,113788,1,3,1648897,556,1727343,3376240
Not considered,Below average state,UTTAR PRADESH,40-49,0,UP,UTTAR PRADESH,9,B0101,Total,Underperformance,0.472968007,1386562,7449038,8835600,411733,999125,1410858,1140544,1498899,2639443,312457,289457,601914,0.353522762,6064306,539916,6604222,408896,130699,539595,1,4,8903869,507,9777310,18681179
Not considered,Below average state,UTTARAKHAND,40-49,0,UP,UTTARAKHAND,5,B0101,Total,Underperformance,0.575244819,167228,440280,607508,25235,42252,67487,66885,57580,124465,17233,10981,28214,0.280184568,271227,24672,295899,14606,5742,20348,1,4,522573,544,533513,1056086
Not considered,Below average state,ASSAM,5-Sep,0,UP,ASSAM,18,B0101,Total,Underperformance,0.005379847,8098,10970,19068,5084,5835,10919,14830,15325,30155,4951,5148,10099,0.983262888,1710114,1774903,3485017,19279,20419,39698,1,4,1737993,516,1806346,3544339
Not considered,Below average state,CHANDIGARH,5-Sep,0,UP,CHANDIGARH,4,B0101,Total,Underperformance,0.009956795,352,556,908,81,96,177,217,234,451,2,5,7,0.985020944,41368,48460,89828,330,415,745,1,4,41939,538,49255,91194
Not considered,Below average state,DADRA & NAGAR HAVELI,5-Sep,0,UP,DADRA & NAGAR HAVELI,26,B0101,Total,Underperformance,0.003503545,53,74,127,18,31,49,63,88,151,9,7,16,0.991889431,17065,18890,35955,65,79,144,1,4,17190,523,19059,36249
Not considered,Below average state,DELHI,5-Sep,0,UP,DELHI,7,B0101,Total,Underperformance,0.004040438,2485,3721,6206,295,403,698,1477,1743,3220,58,89,147,0.993767465,702465,823934,1526399,2475,3209,5684,1,4,706485,500,829487,1535972
Not considered,Below average state,GOA,5-Sep,0,UP,GOA,30,B0101,Total,Underperformance,0.029121999,1476,1610,3086,260,244,504,593,582,1175,15,19,34,0.959468896,49212,52461,101673,762,824,1586,1,4,51296,535,54672,105968
Not considered,Below average state,JAMMU & KASHMIR,5-Sep,0,UP,JAMMU & KASHMIR,1,B0101,Total,Underperformance,0.005576594,3285,4589,7874,3128,3617,6745,7509,8245,15754,3513,3648,7161,0.978194342,650848,730336,1381184,12806,14901,27707,1,4,665155,524,746818,1411973
Not considered,Below average state,JHARKHAND,5-Sep,0,UP,JHARKHAND,20,B0101,Total,Underperformance,0.005821297,10870,13221,24091,4612,5226,9838,17866,17783,35649,14710,13977,28687,0.978632692,1977100,2072898,4049998,15385,16959,32344,1,4,2020546,529,2117879,4138425
Not considered,Below average state,KERALA,5-Sep,0,UP,KERALA,32,B0101,Total,Underperformance,0.002976386,3333,4272,7605,1834,1946,3780,3868,3818,7686,213,260,473,0.993830407,1244508,1294840,2539348,18887,19729,38616,1,4,1251922,539,1303190,2555112
Not considered,Below average state,LAKSHADWEEP,5-Sep,0,UP,LAKSHADWEEP,31,B0101,Total,Underperformance,0.002404291,1,12,13,9,9,18,13,9,22,0,1,1,0.993341964,2633,2738,5371,100,91,191,1,4,2647,528,2760,5407
Not considered,Below average state,MADHYA PRADESH,5-Sep,0,UP,MADHYA PRADESH,23,B0101,Total,Underperformance,0.007151796,26925,32195,59120,6003,6593,12596,24062,24488,48550,14168,13892,28060,0.983580628,3891607,4239118,8130725,24998,28125,53123,1,3,3956762,554,4309693,8266455
Not considered,Below average state,MANIPUR,5-Sep,0,UP,MANIPUR,14,B0101,Total,Underperformance,0.01131701,1534,1762,3296,1169,1291,2460,2598,2765,5363,829,879,1708,0.964404295,136516,144360,280876,3612,3830,7442,1,3,141477,551,149766,291243
Not considered,Below average state,NAGALAND,5-Sep,0,UP,NAGALAND,13,B0101,Total,Underperformance,0.008743066,963,1075,2038,609,691,1300,1954,2038,3992,4030,4205,8235,0.938802826,105505,113329,218834,2405,2670,5075,1,3,112452,567,120647,233099
Not considered,Below average state,ODISHA,5-Sep,0,UP,ODISHA,21,B0101,Total,Underperformance,0.005040287,9121,11417,20538,4839,4844,9683,14730,14036,28766,6789,6307,13096,0.984686245,1958789,2053579,4012368,16098,17473,33571,1,3,1989429,558,2085339,4074768
Not considered,Below average state,PUDUCHERRY,5-Sep,0,UP,PUDUCHERRY,34,B0101,Total,Underperformance,0.004700305,222,242,464,31,45,76,122,165,287,8,9,17,0.992220185,48038,49911,97949,311,335,646,1,4,48390,493,50327,98717
Not considered,Below average state,PUNJAB,5-Sep,0,UP,PUNJAB,3,B0101,Total,Underperformance,0.009936998,9194,14337,23531,3572,4665,8237,12162,15198,27360,808,945,1753,0.977768759,1044173,1271202,2315375,10245,13076,23321,1,3,1066337,556,1301682,2368019
Not considered,Below average state,UTTAR PRADESH,5-Sep,0,UP,UTTAR PRADESH,9,B0101,Total,Underperformance,0.011505556,116920,171429,288349,45039,57911,102950,148274,170993,319267,33464,37289,70753,0.972932062,11512728,12870620,24383348,99581,119866,219447,1,4,11811386,507,13250331,25061717
Not considered,Below average state,UTTARAKHAND,5-Sep,0,UP,UTTARAKHAND,5,B0101,Total,Underperformance,0.007389491,3478,4346,7824,921,1127,2048,3630,4003,7633,2747,2506,5253,0.980440139,488767,549324,1038091,2799,3411,6210,1,4,498622,544,560179,1058801
Not considered,Below average state,ASSAM,50-59,0,UP,ASSAM,18,B0101,Total,Underperformance,0.555350705,191404,946614,1138018,30529,33861,64390,123491,76396,199887,27293,13449,40742,0.327222783,606498,64043,670541,47064,9413,56477,1,4,948686,516,1100502,2049188
Not considered,Below average state,CHANDIGARH,50-59,0,UP,CHANDIGARH,4,B0101,Total,Underperformance,0.617159539,9203,41322,50525,88,186,274,387,542,929,48,105,153,0.369623902,26376,3884,30260,498,274,772,1,4,36014,538,45853,81867
Not considered,Below average state,DADRA & NAGAR HAVELI,50-59,0,UP,DADRA & NAGAR HAVELI,26,B0101,Total,Underperformance,0.559620761,1825,7383,9208,141,160,301,1322,597,1919,206,144,350,0.30247964,4360,617,4977,105,35,140,1,4,7713,523,8741,16454
Not considered,Below average state,DELHI,50-59,0,UP,DELHI,7,B0101,Total,Underperformance,0.558533754,95334,572874,668208,1371,5268,6639,5314,12937,18251,886,2217,3103,0.423617119,449420,57379,506799,6839,6662,13501,1,4,550954,500,645407,1196361
Not considered,Below average state,GOA,50-59,0,UP,GOA,30,B0101,Total,Underperformance,0.473734567,15449,51890,67339,950,2011,2961,3551,5749,9300,1134,1453,2587,0.442639558,51208,11711,62919,2604,1684,4288,1,4,71342,535,70803,142145
Not considered,Below average state,JAMMU & KASHMIR,50-59,0,UP,JAMMU & KASHMIR,1,B0101,Total,Underperformance,0.412282014,35761,297609,333370,17087,42652,59739,49706,65993,115699,24832,18637,43469,0.390873328,269946,46113,316059,22574,6998,29572,1,4,380245,524,428352,808597
Not considered,Below average state,JHARKHAND,50-59,0,UP,JHARKHAND,20,B0101,Total,Underperformance,0.428663337,195038,735768,930806,116921,190675,307596,244636,263819,508455,75431,41795,117226,0.283192296,548024,66904,614928,34221,9980,44201,1,4,1063129,529,1108286,2171415
Not considered,Below average state,KERALA,50-59,0,UP,KERALA,32,B0101,Total,Underperformance,0.453546918,359550,1305218,1664768,42988,61724,104712,121445,173871,295316,45411,35918,81329,0.443840479,1351429,277711,1629140,99238,37333,136571,1,4,1877835,539,1792718,3670553
Not considered,Below average state,LAKSHADWEEP,50-59,0,UP,LAKSHADWEEP,31,B0101,Total,Underperformance,0.442433384,352,2288,2640,59,242,301,66,343,409,50,108,158,0.462543992,2361,399,2760,225,148,373,1,4,2829,528,3138,5967
Not considered,Below average state,MADHYA PRADESH,50-59,0,UP,MADHYA PRADESH,23,B0101,Total,Underperformance,0.592050541,742743,2070947,2813690,172525,165629,338154,417055,240357,657412,80820,36566,117386,0.244918146,1035066,128895,1163961,50237,15382,65619,1,3,2275684,554,2476765,4752449
Not considered,Below average state,MANIPUR,50-59,0,UP,MANIPUR,14,B0101,Total,Underperformance,0.6673261,50551,89438,139989,5017,3081,8098,16545,7982,24527,3874,1421,5295,0.190512737,32799,7166,39965,3114,892,4006,1,3,103769,551,106007,209776
Not considered,Below average state,NAGALAND,50-59,0,UP,NAGALAND,13,B0101,Total,Underperformance,0.788324776,33174,52956,86130,791,617,1408,5082,2576,7658,906,425,1331,0.12940132,10220,3918,14138,516,264,780,1,3,49382,567,59875,109257
Not considered,Below average state,ODISHA,50-59,0,UP,ODISHA,21,B0101,Total,Underperformance,0.460648735,235548,1299118,1534666,143907,153233,297140,334276,245231,579507,82305,40524,122829,0.328536541,977588,116942,1094530,60614,15671,76285,1,3,1629717,558,1701815,3331532
Not considered,Below average state,PUDUCHERRY,50-59,0,UP,PUDUCHERRY,34,B0101,Total,Underperformance,0.51912962,12069,45571,57640,411,750,1161,1721,2697,4418,631,723,1354,0.428885366,41138,6482,47620,1003,449,1452,1,4,55559,493,55473,111032
Not considered,Below average state,PUNJAB,50-59,0,UP,PUNJAB,3,B0101,Total,Underperformance,0.502293286,141960,968620,1110580,16558,28498,45056,46066,53118,99184,14305,11743,26048,0.441066766,859179,116028,975207,40826,11942,52768,1,3,1061510,556,1149509,2211019
Not considered,Below average state,UTTAR PRADESH,50-59,0,UP,UTTAR PRADESH,9,B0101,Total,Underperformance,0.466309617,888699,4730877,5619576,221321,499205,720526,703643,848848,1552491,202347,176960,379307,0.373390747,4058362,441433,4499795,201532,68632,270164,1,4,5853051,507,6198118,12051169
Not considered,Below average state,UTTARAKHAND,50-59,0,UP,UTTARAKHAND,5,B0101,Total,Underperformance,0.54041047,109018,277710,386728,13673,20630,34303,46947,35411,82358,14244,7567,21811,0.314024642,191521,33201,224722,5925,3613,9538,1,4,361730,544,353889,715619
Not considered,Below average state,ASSAM,60-69,0,UP,ASSAM,18,B0101,Total,Underperformance,0.395538324,79670,426358,506028,11287,14521,25808,55446,46484,101930,14604,10478,25082,0.50518236,481084,165216,646300,19832,8261,28093,1,4,630804,516,648536,1279340
Not considered,Below average state,CHANDIGARH,60-69,0,UP,CHANDIGARH,4,B0101,Total,Underperformance,0.237439962,1381,8506,9887,38,113,151,158,334,492,33,69,102,0.748294909,18288,12871,31159,176,300,476,1,4,19860,538,21780,41640
Not considered,Below average state,DADRA & NAGAR HAVELI,60-69,0,UP,DADRA & NAGAR HAVELI,26,B0101,Total,Underperformance,0.359694145,657,2777,3434,50,56,106,650,314,964,112,78,190,0.519430187,3579,1380,4959,77,34,111,1,4,4998,523,4549,9547
Not considered,Below average state,DELHI,60-69,0,UP,DELHI,7,B0101,Total,Underperformance,0.267626274,23834,175406,199240,713,2651,3364,2725,7089,9814,581,1746,2327,0.716065502,339830,193260,533090,2846,5326,8172,1,4,366970,500,377501,744471
Not considered,Below average state,GOA,60-69,0,UP,GOA,30,B0101,Total,Underperformance,0.203999099,4869,15964,20833,361,682,1043,1585,2855,4440,653,939,1592,0.736934873,46911,28347,75258,994,872,1866,1,4,54018,535,48105,102123
Not considered,Below average state,JAMMU & KASHMIR,60-69,0,UP,JAMMU & KASHMIR,1,B0101,Total,Underperformance,0.245884209,12099,117406,129505,6703,22562,29265,22805,42713,65518,12303,14977,27280,0.577925197,203314,101074,304388,10356,6802,17158,1,4,250521,524,276170,526691
Not considered,Below average state,JHARKHAND,60-69,0,UP,JHARKHAND,20,B0101,Total,Underperformance,0.269440428,94159,335027,429186,52919,101372,154291,131867,176331,308198,51228,40912,92140,0.479229747,523208,240147,763355,18314,11652,29966,1,4,800462,529,792417,1592879
Not considered,Below average state,KERALA,60-69,0,UP,KERALA,32,B0101,Total,Underperformance,0.250134372,112903,491623,604526,13037,19719,32756,51858,90435,142293,21045,24654,45699,0.672080288,1086631,537656,1624287,31369,21983,53352,1,4,1272437,539,1144368,2416805
Not considered,Below average state,LAKSHADWEEP,60-69,0,UP,LAKSHADWEEP,31,B0101,Total,Underperformance,0.078038874,22,247,269,15,92,107,20,150,170,5,77,82,0.848854076,1601,1325,2926,63,175,238,1,4,1648,528,1799,3447
Not considered,Below average state,MADHYA PRADESH,60-69,0,UP,MADHYA PRADESH,23,B0101,Total,Underperformance,0.418797231,384149,1045822,1429971,87353,91555,178908,243877,168965,412842,69205,39188,108393,0.428548083,1047772,415493,1463265,32239,17602,49841,1,3,1745003,554,1669468,3414471
Not considered,Below average state,MANIPUR,60-69,0,UP,MANIPUR,14,B0101,Total,Underperformance,0.520502763,21685,40018,61703,1968,1534,3502,7459,5071,12530,2343,1167,3510,0.34418997,27273,13529,40802,1527,799,2326,1,3,58760,551,59785,118545
Not considered,Below average state,NAGALAND,60-69,0,UP,NAGALAND,13,B0101,Total,Underperformance,0.663704289,16853,23475,40328,355,335,690,2722,2048,4770,765,499,1264,0.236990224,7938,6462,14400,318,292,610,1,3,28278,567,32484,60762
Not considered,Below average state,ODISHA,60-69,0,UP,ODISHA,21,B0101,Total,Underperformance,0.295006574,102652,621172,723824,54972,78319,133291,158715,173587,332302,51704,41912,93616,0.531403423,915031,388813,1303844,31887,17662,49549,1,3,1228102,558,1225484,2453586
Not considered,Below average state,PUDUCHERRY,60-69,0,UP,PUDUCHERRY,34,B0101,Total,Underperformance,0.234225954,3686,13134,16820,158,288,446,809,1419,2228,317,415,732,0.724554734,34347,17684,52031,392,339,731,1,4,39159,493,32652,71811
Not considered,Below average state,PUNJAB,60-69,0,UP,PUNJAB,3,B0101,Total,Underperformance,0.338398464,67350,513402,580752,10887,18977,29864,30972,40371,71343,10808,11154,21962,0.607233632,751759,290362,1042121,26304,13547,39851,1,3,860889,556,855289,1716178
Not considered,Below average state,UTTAR PRADESH,60-69,0,UP,UTTAR PRADESH,9,B0101,Total,Underperformance,0.379624124,562006,3061567,3623573,128057,317765,445822,450536,645794,1096330,151087,167948,319035,0.472094968,3454288,1051934,4506222,128988,72950,201938,1,4,4617917,507,4927243,9545160
Not considered,Below average state,UTTARAKHAND,60-69,0,UP,UTTARAKHAND,5,B0101,Total,Underperformance,0.357962086,59288,136809,196097,6615,12563,19178,29153,29836,58989,13321,9337,22658,0.492996723,174421,95650,270071,3641,3458,7099,1,4,276183,544,271632,547815
Not considered,Below average state,ASSAM,60+,0,UP,ASSAM,18,B0101,Total,Underperformance,0.34722575,109219,612505,721724,15065,20263,35328,74065,69667,143732,19785,16953,36738,0.565949049,820658,355692,1176350,26942,11899,38841,1,4,1023727,516,1054817,2078544
Not considered,Below average state,CHANDIGARH,60+,0,UP,CHANDIGARH,4,B0101,Total,Underperformance,0.191404037,1798,11041,12839,48,132,180,230,467,697,39,93,132,0.796237216,30178,23232,53410,234,367,601,1,4,32245,538,34833,67078
Not considered,Below average state,DADRA & NAGAR HAVELI,60+,0,UP,DADRA & NAGAR HAVELI,26,B0101,Total,Underperformance,0.305787504,819,3429,4248,63,65,128,787,410,1197,147,106,253,0.589835877,5780,2414,8194,88,40,128,1,4,7533,523,6359,13892
Not considered,Below average state,DELHI,60+,0,UP,DELHI,7,B0101,Total,Underperformance,0.216828693,29683,219116,248799,881,3148,4029,3657,9161,12818,776,2261,3037,0.769353651,536574,346217,882791,3722,6744,10466,1,4,570690,500,576755,1147445
Not considered,Below average state,GOA,60+,0,UP,GOA,30,B0101,Total,Underperformance,0.169301814,6763,20917,27680,456,833,1289,2111,3755,5866,829,1235,2064,0.782195174,79477,48408,127885,1306,1105,2411,1,4,89180,535,74315,163495
Not considered,Below average state,JAMMU & KASHMIR,60+,0,UP,JAMMU & KASHMIR,1,B0101,Total,Underperformance,0.207838024,18037,173726,191763,9407,32363,41770,31768,64631,96399,17207,24331,41538,0.642662054,373064,219892,592956,15021,10418,25439,1,4,440076,524,482580,922656
Not considered,Below average state,JHARKHAND,60+,0,UP,JHARKHAND,20,B0101,Total,Underperformance,0.234501701,116984,435661,552645,63040,126094,189134,161688,230988,392676,64764,58670,123434,0.546499352,831497,456426,1287923,23556,16335,39891,1,4,1174933,529,1181745,2356678
Not considered,Below average state,KERALA,60+,0,UP,KERALA,32,B0101,Total,Underperformance,0.185190131,141455,635120,776575,15480,23750,39230,65321,120202,185523,26552,34840,61392,0.755927956,2076470,1093433,3169903,40086,26911,66997,1,4,2309798,539,1883595,4193393
Not considered,Below average state,LAKSHADWEEP,60+,0,UP,LAKSHADWEEP,31,B0101,Total,Underperformance,0.062239089,28,300,328,20,120,140,26,187,213,7,98,105,0.877419355,2535,2089,4624,80,214,294,1,4,2596,528,2674,5270
Not considered,Below average state,MADHYA PRADESH,60+,0,UP,MADHYA PRADESH,23,B0101,Total,Underperformance,0.350604623,513607,1489508,2003115,111221,125069,236290,323041,251086,574127,100569,68507,169076,0.519312777,2006543,960455,2966998,45809,27082,72891,1,3,2943760,554,2769556,5713316
Not considered,Below average state,MANIPUR,60+,0,UP,MANIPUR,14,B0101,Total,Underperformance,0.43810119,30397,57232,87629,2641,2216,4857,10412,7895,18307,3374,2075,5449,0.443130687,56042,32593,88635,2122,1186,3308,1,3,100225,551,99795,200020
Not considered,Below average state,NAGALAND,60+,0,UP,NAGALAND,13,B0101,Total,Underperformance,0.607596908,25554,36862,62416,524,497,1021,4186,3479,7665,1318,992,2310,0.295300119,16889,13446,30335,477,433,910,1,3,47947,567,54779,102726
Not considered,Below average state,ODISHA,60+,0,UP,ODISHA,21,B0101,Total,Underperformance,0.240187599,132324,824691,957015,65934,98156,164090,196012,236614,432626,65538,62741,128279,0.619038823,1596304,870224,2466528,42193,25167,67360,1,3,1990178,558,1994270,3984448
Not considered,Below average state,PUDUCHERRY,60+,0,UP,PUDUCHERRY,34,B0101,Total,Underperformance,0.18266133,4882,17117,21999,189,352,541,1035,1886,2921,426,579,1005,0.784740443,60674,33837,94511,534,460,994,1,4,67017,493,53419,120436
Not considered,Below average state,PUNJAB,60+,0,UP,PUNJAB,3,B0101,Total,Underperformance,0.283676522,92049,720916,812965,13978,26117,40095,42000,59181,101181,13940,16872,30812,0.670265757,1274166,646693,1920859,34047,19547,53594,1,3,1422155,556,1443662,2865817
Not considered,Below average state,UTTAR PRADESH,60+,0,UP,UTTAR PRADESH,9,B0101,Total,Underperformance,0.341431721,799172,4472501,5271673,170244,436584,606828,619362,951802,1571164,212630,265862,478492,0.525817712,5771607,2346968,8118575,171824,109321,281145,1,4,7402771,507,8037133,15439904
Not considered,Below average state,UTTARAKHAND,60+,0,UP,UTTARAKHAND,5,B0101,Total,Underperformance,0.30447964,80203,194075,274278,8411,16252,24663,39250,42668,81918,19837,15439,35276,0.565421749,319622,189715,509337,5023,4779,9802,1,4,458912,544,441897,900809
Not considered,Below average state,ASSAM,70-79,0,UP,ASSAM,18,B0101,Total,Underperformance,0.296477181,22504,146378,168882,2662,4116,6778,14037,17659,31696,4014,4956,8970,0.632132493,236030,124051,360081,5081,2486,7567,1,4,276585,516,293044,569629
Not considered,Below average state,CHANDIGARH,70-79,0,UP,CHANDIGARH,4,B0101,Total,Underperformance,0.125287808,273,1958,2231,8,13,21,57,95,152,4,18,22,0.864940754,8220,7182,15402,37,53,90,1,4,8554,538,9253,17807
Not considered,Below average state,DADRA & NAGAR HAVELI,70-79,0,UP,DADRA & NAGAR HAVELI,26,B0101,Total,Underperformance,0.192837466,125,505,630,11,5,16,110,80,190,30,23,53,0.732782369,1635,759,2394,6,4,10,1,4,1900,523,1367,3267
Not considered,Below average state,DELHI,70-79,0,UP,DELHI,7,B0101,Total,Underperformance,0.12919091,4112,33346,37458,114,367,481,669,1536,2205,151,398,549,0.861310671,139618,110113,249731,560,990,1550,1,4,144550,500,145393,289943
Not considered,Below average state,GOA,70-79,0,UP,GOA,30,B0101,Total,Underperformance,0.11649229,1392,3919,5311,71,116,187,400,727,1127,151,244,395,0.850123928,23530,15228,38758,206,173,379,1,4,25473,535,20118,45591
Not considered,Below average state,JAMMU & KASHMIR,70-79,0,UP,JAMMU & KASHMIR,1,B0101,Total,Underperformance,0.172496702,4162,42256,46418,1832,7258,9090,6580,16517,23097,3745,6875,10620,0.702205541,114042,74918,188960,3153,2532,5685,1,4,128529,524,140566,269095
Not considered,Below average state,JHARKHAND,70-79,0,UP,JHARKHAND,20,B0101,Total,Underperformance,0.174156874,18234,81917,100151,7941,20132,28073,23916,44912,68828,11040,14312,25352,0.662069481,227452,153279,380731,4074,3645,7719,1,4,280642,529,294420,575062
Not considered,Below average state,KERALA,70-79,0,UP,KERALA,32,B0101,Total,Underperformance,0.11718266,23577,121113,144690,1967,3455,5422,11133,25115,36248,4649,8433,13082,0.842865577,660501,380218,1040719,6578,4059,10637,1,4,699860,539,534879,1234739
Not considered,Below average state,LAKSHADWEEP,70-79,0,UP,LAKSHADWEEP,31,B0101,Total,Underperformance,0.02757079,2,35,37,4,12,16,5,22,27,2,15,17,0.939642325,679,582,1261,11,33,44,1,4,688,528,654,1342
Not considered,Below average state,MADHYA PRADESH,70-79,0,UP,MADHYA PRADESH,23,B0101,Total,Underperformance,0.275397112,100877,348234,449111,18558,26290,44848,62606,64134,126740,25037,22107,47144,0.61797635,652203,355578,1007781,10152,6839,16991,1,3,840723,554,790053,1630776
Not considered,Below average state,MANIPUR,70-79,0,UP,MANIPUR,14,B0101,Total,Underperformance,0.356351359,6675,13167,19842,520,501,1021,2283,2082,4365,811,650,1461,0.5390169,18473,11540,30013,401,242,643,1,3,28242,551,27439,55681
Not considered,Below average state,NAGALAND,70-79,0,UP,NAGALAND,13,B0101,Total,Underperformance,0.57859223,6604,9688,16292,121,109,230,1102,989,2091,375,309,684,0.322856737,5182,3909,9091,99,91,190,1,3,13263,567,14895,28158
Not considered,Below average state,ODISHA,70-79,0,UP,ODISHA,21,B0101,Total,Underperformance,0.169276263,23734,168034,191768,8469,16062,24531,30234,52146,82380,11692,17133,28825,0.732561547,503281,326616,829897,8163,5886,14049,1,3,568941,558,563929,1132870
Not considered,Below average state,PUDUCHERRY,70-79,0,UP,PUDUCHERRY,34,B0101,Total,Underperformance,0.119342962,945,3269,4214,26,49,75,188,384,572,87,133,220,0.858227131,18735,11569,30304,109,92,201,1,4,19955,493,15355,35310
Not considered,Below average state,PUNJAB,70-79,0,UP,PUNJAB,3,B0101,Total,Underperformance,0.232847879,17804,161521,179325,2234,5531,7765,7893,14209,22102,2364,4438,6802,0.729621185,339754,222155,561909,5761,4564,10325,1,3,367815,556,402323,770138
Not considered,Below average state,UTTAR PRADESH,70-79,0,UP,UTTAR PRADESH,9,B0101,Total,Underperformance,0.301763484,172921,1058956,1231877,29876,87211,117087,122010,225135,347145,45807,72470,118277,0.58422565,1567553,817408,2384961,31048,25450,56498,1,4,1908291,507,2173969,4082260
Not considered,Below average state,UTTARAKHAND,70-79,0,UP,UTTARAKHAND,5,B0101,Total,Underperformance,0.243565817,16481,43945,60426,1349,2906,4255,8023,10150,18173,5230,4723,9953,0.643063578,96548,62989,159537,938,949,1887,1,4,126282,544,121807,248089
Not considered,Below average state,ASSAM,80+,0,UP,ASSAM,18,B0101,Total,Underperformance,0.203915932,7045,39769,46814,1116,1626,2742,4582,5524,10106,1167,1519,2686,0.740363716,103544,66425,169969,2029,1152,3181,1,4,116338,516,113237,229575
Not considered,Below average state,CHANDIGARH,80+,0,UP,CHANDIGARH,4,B0101,Total,Underperformance,0.09448303,144,577,721,2,6,8,15,38,53,2,6,8,0.89752326,3670,3179,6849,21,14,35,1,4,3831,538,3800,7631
Not considered,Below average state,DADRA & NAGAR HAVELI,80+,0,UP,DADRA & NAGAR HAVELI,26,B0101,Total,Underperformance,0.170686456,37,147,184,2,4,6,27,16,43,5,5,10,0.780148423,566,275,841,5,2,7,1,4,635,523,443,1078
Not considered,Below average state,DELHI,80+,0,UP,DELHI,7,B0101,Total,Underperformance,0.107059125,1737,10364,12101,54,130,184,263,536,799,44,117,161,0.884447629,57126,42844,99970,316,428,744,1,4,59170,500,53861,113031
Not considered,Below average state,GOA,80+,0,UP,GOA,30,B0101,Total,Underperformance,0.097332235,502,1034,1536,24,35,59,126,173,299,25,52,77,0.878841645,9036,4833,13869,106,60,166,1,4,9689,535,6092,15781
Not considered,Below average state,JAMMU & KASHMIR,80+,0,UP,JAMMU & KASHMIR,1,B0101,Total,Underperformance,0.124852211,1776,14064,15840,872,2543,3415,2383,5401,7784,1159,2479,3638,0.785118625,55708,43900,99608,1512,1084,2596,1,4,61026,524,65844,126870
Not considered,Below average state,JHARKHAND,80+,0,UP,JHARKHAND,20,B0101,Total,Underperformance,0.123494598,4591,18717,23308,2180,4590,6770,5905,9745,15650,2496,3446,5942,0.76210282,80837,63000,143837,1168,1038,2206,1,4,93829,529,94908,188737
Not considered,Below average state,KERALA,80+,0,UP,KERALA,32,B0101,Total,Underperformance,0.050491927,4975,22384,27359,476,576,1052,2330,4652,6982,858,1753,2611,0.931803879,329338,175559,504897,2139,869,3008,1,4,337501,539,204348,541849
Not considered,Below average state,LAKSHADWEEP,80+,0,UP,LAKSHADWEEP,31,B0101,Total,Underperformance,0.045738046,4,18,22,1,16,17,1,15,16,0,6,6,0.908523909,255,182,437,6,6,12,1,4,260,528,221,481
Not considered,Below average state,MADHYA PRADESH,80+,0,UP,MADHYA PRADESH,23,B0101,Total,Underperformance,0.185658966,28581,95452,124033,5310,7224,12534,16558,17987,34545,6327,7212,13539,0.742366432,306568,189384,495952,3418,2641,6059,1,3,358034,554,310035,668069
Not considered,Below average state,MANIPUR,80+,0,UP,MANIPUR,14,B0101,Total,Underperformance,0.235868807,2037,4047,6084,153,181,334,670,742,1412,220,258,478,0.690858339,10296,7524,17820,194,145,339,1,3,13223,551,12571,25794
Not considered,Below average state,NAGALAND,80+,0,UP,NAGALAND,13,B0101,Total,Underperformance,0.419817471,2097,3699,5796,48,53,101,362,442,804,178,184,362,0.495726496,3769,3075,6844,60,50,110,1,3,6406,567,7400,13806
Not considered,Below average state,ODISHA,80+,0,UP,ODISHA,21,B0101,Total,Underperformance,0.104079982,5938,35485,41423,2493,3775,6268,7063,10881,17944,2142,3696,5838,0.836165049,177992,154795,332787,2143,1619,3762,1,3,193135,558,204857,397992
Not considered,Below average state,PUDUCHERRY,80+,0,UP,PUDUCHERRY,34,B0101,Total,Underperformance,0.072474653,251,714,965,5,15,20,38,83,121,22,31,53,0.914457379,7592,4584,12176,33,29,62,1,4,7903,493,5412,13315
Not considered,Below average state,PUNJAB,80+,0,UP,PUNJAB,3,B0101,Total,Underperformance,0.139361952,6895,45993,52888,857,1609,2466,3135,4601,7736,768,1280,2048,0.834856825,182653,134176,316829,1982,1436,3418,1,3,193451,556,186050,379501
Not considered,Below average state,UTTAR PRADESH,80+,0,UP,UTTAR PRADESH,9,B0101,Total,Underperformance,0.229642303,64245,351978,416223,12311,31608,43919,46816,80873,127689,15736,25444,41180,0.677187771,749766,477626,1227392,11788,10921,22709,1,4,876563,507,935921,1812484
Not considered,Below average state,UTTARAKHAND,80+,0,UP,UTTARAKHAND,5,B0101,Total,Underperformance,0.169248368,4434,13321,17755,447,783,1230,2074,2682,4756,1286,1379,2665,0.760011439,48653,31076,79729,444,372,816,1,4,56447,544,48458,104905
Not considered,Below average state,ASSAM,Age not stated,0,UP,ASSAM,18,B0101,Total,Underperformance,0.228697408,928,3377,4305,343,423,766,885,780,1665,124,111,235,0.670367616,6993,5626,12619,446,328,774,1,4,8930,516,9894,18824
Not considered,Below average state,CHANDIGARH,Age not stated,0,UP,CHANDIGARH,4,B0101,Total,Underperformance,0.335260116,30,86,116,2,2,4,5,4,9,0,2,2,0.632947977,110,109,219,4,7,11,1,4,145,538,201,346
Not considered,Below average state,DADRA & NAGAR HAVELI,Age not stated,0,UP,DADRA & NAGAR HAVELI,26,B0101,Total,Underperformance,0.258064516,20,76,96,1,1,2,13,10,23,1,0,1,0.677419355,138,114,252,0,3,3,1,4,172,523,200,372
Not considered,Below average state,DELHI,Age not stated,0,UP,DELHI,7,B0101,Total,Underperformance,0.254879655,646,3611,4257,34,81,115,116,223,339,15,31,46,0.722069213,6750,5310,12060,224,234,458,1,4,7527,500,9175,16702
Not considered,Below average state,GOA,Age not stated,0,UP,GOA,30,B0101,Total,Underperformance,0.35052531,235,499,734,26,37,63,52,90,142,12,16,28,0.568290353,697,493,1190,37,31,68,1,4,996,535,1098,2094
Not considered,Below average state,JAMMU & KASHMIR,Age not stated,0,UP,JAMMU & KASHMIR,1,B0101,Total,Underperformance,0.193068325,342,2577,2919,180,363,543,364,566,930,119,185,304,0.725312521,4547,6419,10966,384,309,693,1,4,5372,524,9747,15119
Not considered,Below average state,JHARKHAND,Age not stated,0,UP,JHARKHAND,20,B0101,Total,Underperformance,0.213836586,5335,19627,24962,2358,4746,7104,4954,7221,12175,1542,1108,2650,0.659165282,42651,34296,76947,2305,2500,4805,1,4,54482,529,62252,116734
Not considered,Below average state,KERALA,Age not stated,0,UP,KERALA,32,B0101,Total,Underperformance,0.209882271,1963,5275,7238,337,411,748,660,918,1578,180,154,334,0.734674941,14386,10950,25336,1545,670,2215,1,4,17189,539,17297,34486
Not considered,Below average state,LAKSHADWEEP,Age not stated,0,UP,LAKSHADWEEP,31,B0101,Total,Underperformance,0.086956522,1,9,10,1,7,8,1,10,11,1,2,3,0.791304348,38,53,91,3,9,12,1,4,41,528,74,115
Not considered,Below average state,MADHYA PRADESH,Age not stated,0,UP,MADHYA PRADESH,23,B0101,Total,Underperformance,0.230696821,5007,14109,19116,1176,1630,2806,2929,2959,5888,561,508,1069,0.685344307,30989,25800,56789,919,868,1787,1,3,39486,554,43376,82862
Not considered,Below average state,MANIPUR,Age not stated,0,UP,MANIPUR,14,B0101,Total,Underperformance,0.287900219,761,1478,2239,159,121,280,406,260,666,76,54,130,0.609746689,2302,2440,4742,206,177,383,1,3,3545,551,4232,7777
Not considered,Below average state,NAGALAND,Age not stated,0,UP,NAGALAND,13,B0101,Total,Underperformance,0.33310673,174,316,490,20,13,33,41,54,95,41,38,79,0.54860639,366,441,807,19,20,39,1,3,622,567,849,1471
Not considered,Below average state,ODISHA,Age not stated,0,UP,ODISHA,21,B0101,Total,Underperformance,0.216755754,5136,20695,25831,3570,4338,7908,7545,7249,14794,1482,1121,2603,0.637260743,43661,32282,75943,2512,2257,4769,1,3,57824,558,61347,119171
Not considered,Below average state,PUDUCHERRY,Age not stated,0,UP,PUDUCHERRY,34,B0101,Total,Underperformance,0.213442325,50,185,235,7,10,17,14,20,34,4,12,16,0.741144414,473,343,816,20,21,41,1,4,541,493,560,1101
Not considered,Below average state,PUNJAB,Age not stated,0,UP,PUNJAB,3,B0101,Total,Underperformance,0.237873898,1650,8227,9877,351,628,979,838,1202,2040,171,202,373,0.704012331,16591,12641,29232,799,593,1392,1,3,19250,556,22272,41522
Not considered,Below average state,UTTAR PRADESH,Age not stated,0,UP,UTTAR PRADESH,9,B0101,Total,Underperformance,0.21719515,62787,289517,352304,17831,43638,61469,58045,85341,143386,13012,15463,28475,0.676852673,622285,475612,1097897,18154,19510,37664,1,4,756129,507,865933,1622062
Not considered,Below average state,UTTARAKHAND,Age not stated,0,UP,UTTARAKHAND,5,B0101,Total,Underperformance,0.256382466,1016,3242,4258,233,423,656,601,826,1427,165,145,310,0.639029383,5514,5099,10613,232,251,483,1,4,7296,544,9312,16608
Not considered,Below average state,ASSAM,Oct-14,0,UP,ASSAM,18,B0101,Total,Underperformance,0.023038456,21469,58975,80444,18880,32742,51622,42625,58044,100669,19868,24509,44377,0.935421641,1618384,1647853,3266237,60699,68583,129282,1,4,1702346,516,1789381,3491727
Not considered,Below average state,CHANDIGARH,Oct-14,0,UP,CHANDIGARH,4,B0101,Total,Underperformance,0.023827356,777,1450,2227,110,163,273,280,360,640,33,56,89,0.968372849,40234,50274,90508,577,887,1464,1,4,41324,538,52140,93464
Not considered,Below average state,DADRA & NAGAR HAVELI,Oct-14,0,UP,DADRA & NAGAR HAVELI,26,B0101,Total,Underperformance,0.026483444,402,525,927,99,57,156,350,170,520,171,143,314,0.949690027,15695,17547,33242,118,117,235,1,4,16618,523,18385,35003
Not considered,Below average state,DELHI,Oct-14,0,UP,DELHI,7,B0101,Total,Underperformance,0.01229684,4959,15308,20267,622,1302,1924,2268,3361,5629,259,589,848,0.983773292,745215,876188,1621403,5903,10658,16561,1,4,752701,500,895446,1648147
Not considered,Below average state,GOA,Oct-14,0,UP,GOA,30,B0101,Total,Underperformance,0.034543964,1681,2153,3834,370,440,810,823,904,1727,70,83,153,0.948517421,50998,54277,105275,1533,1619,3152,1,4,53572,535,57417,110989
Not considered,Below average state,JAMMU & KASHMIR,Oct-14,0,UP,JAMMU & KASHMIR,1,B0101,Total,Underperformance,0.012486447,6069,11585,17654,9888,11904,21792,18569,18554,37123,14621,14736,29357,0.940493106,629739,699980,1329719,33767,37415,71182,1,4,668998,524,744855,1413853
Not considered,Below average state,JHARKHAND,Oct-14,0,UP,JHARKHAND,20,B0101,Total,Underperformance,0.016300815,26302,40603,66905,27395,35322,62717,62286,64786,127072,60531,57341,117872,0.924020733,1842650,1949897,3792547,34475,43067,77542,1,4,1991769,529,2112627,4104396
Not considered,Below average state,KERALA,Oct-14,0,UP,KERALA,32,B0101,Total,Underperformance,0.005013515,4829,9323,14152,3932,4454,8386,6669,7357,14026,632,862,1494,0.989488339,1371723,1421375,2793098,43784,46479,90263,1,4,1383853,539,1438917,2822770
Not considered,Below average state,LAKSHADWEEP,Oct-14,0,UP,LAKSHADWEEP,31,B0101,Total,Underperformance,0.002500834,8,7,15,7,18,25,9,18,27,1,2,3,0.992497499,3126,2827,5953,229,208,437,1,4,3144,528,2854,5998
Not considered,Below average state,MADHYA PRADESH,Oct-14,0,UP,MADHYA PRADESH,23,B0101,Total,Underperformance,0.02652694,90427,136763,227190,42684,51027,93711,100065,97111,197176,70726,69417,140143,0.934087345,3863954,4136038,7999992,57502,73488,130990,1,3,4125172,554,4439329,8564501
Not considered,Below average state,MANIPUR,Oct-14,0,UP,MANIPUR,14,B0101,Total,Underperformance,0.027119195,3907,4602,8509,2646,2578,5224,4921,4816,9737,2778,2695,5473,0.924404726,141011,149033,290044,6994,7280,14274,1,3,152617,551,161146,313763
Not considered,Below average state,NAGALAND,Oct-14,0,UP,NAGALAND,13,B0101,Total,Underperformance,0.036288912,4146,4878,9024,2448,2730,5178,6835,7193,14028,12856,13617,26473,0.800841272,95597,103549,199146,4163,4627,8790,1,3,119434,567,129237,248671
Not considered,Below average state,ODISHA,Oct-14,0,UP,ODISHA,21,B0101,Total,Underperformance,0.016453247,26641,44908,71549,40831,40616,81447,69734,63494,133228,35637,31602,67239,0.937447814,2013078,2063531,4076609,52382,62061,114443,1,3,2145090,558,2203535,4348625
Not considered,Below average state,PUDUCHERRY,Oct-14,0,UP,PUDUCHERRY,34,B0101,Total,Underperformance,0.0090517,315,642,957,66,77,143,196,208,404,18,26,44,0.986710932,51261,53060,104321,581,700,1281,1,4,51790,493,53936,105726
Not considered,Below average state,PUNJAB,Oct-14,0,UP,PUNJAB,3,B0101,Total,Underperformance,0.025865893,18063,48759,66822,8185,12780,20965,20134,27681,47815,4002,5362,9364,0.952000889,1095673,1363728,2459401,23297,34005,57302,1,3,1137872,556,1445530,2583402
Not considered,Below average state,UTTAR PRADESH,Oct-14,0,UP,UTTAR PRADESH,9,B0101,Total,Underperformance,0.023500379,191873,416079,607952,93770,166949,260719,277301,357697,634998,117603,137784,255387,0.942081798,11603950,12767594,24371544,189923,276391,466314,1,4,12190727,507,13679154,25869881
Not considered,Below average state,UTTARAKHAND,Oct-14,0,UP,UTTARAKHAND,5,B0101,Total,Underperformance,0.017701248,7321,12953,20274,2732,4225,6957,9410,9979,19389,11552,10506,22058,0.94611134,513786,569836,1083622,6354,8972,15326,1,4,542069,544,603274,1145343
Not considered,Below average state,ASSAM,Total,0,UP,ASSAM,18,B0101,Total,Underperformance,0.278383677,1652481,7034642,8687123,636894,867450,1504344,1445616,1251614,2697230,330033,255304,585337,0.616424642,11838003,7397883,19235886,1605363,941932,2547295,1,4,15266133,516,15939443,31205576
Not considered,Below average state,CHANDIGARH,Total,0,UP,CHANDIGARH,4,B0101,Total,Underperformance,0.365653513,68739,317190,385929,2877,5209,8086,6131,9057,15188,1107,1912,3019,0.617096025,398810,252504,651314,28916,19660,48576,1,4,474787,538,580663,1055450
Not considered,Below average state,DADRA & NAGAR HAVELI,Total,0,UP,DADRA & NAGAR HAVELI,26,B0101,Total,Underperformance,0.379096852,21174,109125,130299,2633,2704,5337,14551,8364,22915,2143,1804,3947,0.542749826,112081,74467,186548,4644,2451,7095,1,4,149949,523,193760,343709
Not considered,Below average state,DELHI,Total,0,UP,DELHI,7,B0101,Total,Underperformance,0.316139365,744619,4562710,5307329,28151,91260,119411,68321,166929,235250,12083,32387,44470,0.667198676,6975592,4225300,11200892,308682,323569,632251,1,4,7800615,500,8987326,16787941
Not considered,Below average state,GOA,Total,0,UP,GOA,30,B0101,Total,Underperformance,0.32638897,119086,356967,476053,16756,28842,45598,30543,50303,80846,8083,12266,20349,0.604230243,561693,319604,881297,74831,42475,117306,1,4,719405,535,739140,1458545
Not considered,Below average state,JAMMU & KASHMIR,Total,0,UP,JAMMU & KASHMIR,1,B0101,Total,Underperformance,0.210835286,338361,2305788,2644149,293817,542984,836801,525888,675679,1201567,263374,213623,476997,0.655321832,4773017,3445572,8218589,683501,454392,1137893,1,4,5900640,524,6640662,12541302
Not considered,Below average state,JHARKHAND,Total,0,UP,JHARKHAND,20,B0101,Total,Underperformance,0.206698415,1584153,5234442,6818595,1325201,2141262,3466463,2308586,2644953,4953539,780766,545374,1326140,0.602939833,11384314,8505546,19889860,795583,680240,1475823,1,4,16057819,529,16930315,32988134
Not considered,Below average state,KERALA,Total,0,UP,KERALA,32,B0101,Total,Underperformance,0.279283062,2149919,7179828,9329747,479523,637148,1116671,766506,1061697,1828203,251069,210044,461113,0.652186979,14211155,7575843,21786998,2764097,1157115,3921212,1,4,17378649,539,16027412,33406061
Not considered,Below average state,LAKSHADWEEP,Total,0,UP,LAKSHADWEEP,31,B0101,Total,Underperformance,0.167574023,1667,9137,10804,1465,4841,6306,1097,4265,5362,671,1916,2587,0.709134056,27915,17805,45720,7438,5244,12682,1,4,31350,528,33123,64473
Not considered,Below average state,MADHYA PRADESH,Total,0,UP,MADHYA PRADESH,23,B0101,Total,Underperformance,0.312585935,6340054,16362065,22702119,2053918,2400133,4454051,4162944,3146582,7309526,924165,638323,1562488,0.565255125,23587340,17465336,41052676,1285866,1064309,2350175,1,3,35014503,554,37612306,72626809
Not considered,Below average state,MANIPUR,Total,0,UP,MANIPUR,14,B0101,Total,Underperformance,0.341118092,359028,615135,974163,79329,63532,142861,161647,98584,260231,44527,25689,70216,0.543170831,852006,699178,1551184,120374,97892,218266,1,3,1417208,551,1438586,2855794
Not considered,Below average state,NAGALAND,Total,0,UP,NAGALAND,13,B0101,Total,Underperformance,0.37461625,298975,442204,741179,34578,35503,70081,80852,61126,141978,46938,44027,90965,0.507646694,527088,477292,1004380,52806,48436,101242,1,3,953853,567,1024649,1978502
Not considered,Below average state,ODISHA,Total,0,UP,ODISHA,21,B0101,Total,Underperformance,0.255098094,1913130,8794413,10707543,1700747,2025159,3725906,2986517,2610626,5597143,739287,497616,1236903,0.58208658,15123148,9309481,24432629,1529962,1118027,2647989,1,3,20762082,558,21212136,41974218
Not considered,Below average state,PUDUCHERRY,Total,0,UP,PUDUCHERRY,34,B0101,Total,Underperformance,0.320275683,93280,306409,399689,6340,10466,16806,14416,21411,35827,4341,5111,9452,0.6434417,523405,279580,802985,43542,25123,68665,1,4,635442,493,612511,1247953
Not considered,Below average state,PUNJAB,Total,0,UP,PUNJAB,3,B0101,Total,Underperformance,0.304611363,1186305,7264631,8450936,242827,431110,673937,488889,661526,1150415,148011,148000,296011,0.643252661,11280668,6565308,17845976,933100,621876,1554976,1,3,13103873,556,14639465,27743338
Not considered,Below average state,UTTAR PRADESH,Total,0,UP,UTTAR PRADESH,9,B0101,Total,Underperformance,0.223387063,7215193,37420299,44635492,2570098,6826277,9396375,6728345,10156804,16885149,2024415,2269659,4294074,0.670617367,79363878,54633748,133997626,4315015,4257744,8572759,1,4,95331831,507,104480510,199812341
Not considered,Below average state,UTTARAKHAND,Total,0,UP,UTTARAKHAND,5,B0101,Total,Underperformance,0.284606474,799864,2070760,2870624,166732,274955,441687,383367,373473,756840,137123,107688,244811,0.616085376,3628165,2585852,6214017,223503,209349,432852,1,4,4948519,544,5137773,10086292
States needing Special Attention,Below average state,BIHAR,15-19,0,UP,BIHAR,10,B0101,Total,Underperformance,0.110478064,226174,820351,1046525,157081,459325,616406,285850,573540,859390,98246,143592,241838,0.773269064,3571844,3753098,7324942,417935,714962,1132897,1,4,4182114,446,5290581,9472695
States needing Special Attention,Below average state,HARYANA,15-19,0,UP,HARYANA,6,B0101,Total,Underperformance,0.098919844,45803,219044,264847,26017,65082,91099,50201,78396,128597,25330,32864,58194,0.831314078,1068508,1157244,2225752,102107,174271,276378,1,4,1189842,505,1487548,2677390
States needing Special Attention,Below average state,BIHAR,15-59,0,UP,BIHAR,10,B0101,Total,Underperformance,0.337461676,3490956,14822285,18313241,1829433,4375627,6205060,3601997,5712011,9314008,1006014,958377,1964391,0.454709058,17914456,6761521,24675977,2154682,1792534,3947216,1,4,26013423,446,28254194,54267617
States needing Special Attention,Below average state,HARYANA,15-59,0,UP,HARYANA,6,B0101,Total,Underperformance,0.411929968,1062210,5362340,6424550,245162,523166,768328,669843,682288,1352131,183707,146484,330191,0.480202734,5420984,2068363,7489347,546796,473194,1019990,1,4,7336744,505,8259475,15596219
States needing Special Attention,Below average state,BIHAR,20-24,0,UP,BIHAR,10,B0101,Total,Underperformance,0.259308458,430320,1660934,2091254,273816,703675,977491,506304,853763,1360067,141351,151650,293001,0.535716673,2776175,1544238,4320413,452178,559893,1012071,1,4,3854150,446,4210585,8064735
States needing Special Attention,Below average state,HARYANA,20-24,0,UP,HARYANA,6,B0101,Total,Underperformance,0.314830149,124139,684183,808322,47096,117314,164410,99351,135050,234401,29539,32627,62166,0.569661139,941658,520939,1462597,161609,186639,348248,1,4,1194687,505,1372799,2567486
States needing Special Attention,Below average state,BIHAR,25-29,0,UP,BIHAR,10,B0101,Total,Underperformance,0.353488305,534555,2177303,2711858,305440,721220,1026660,576088,906039,1482127,156793,142828,299621,0.41426241,2575582,602517,3178099,374258,249826,624084,1,4,3843018,446,3828687,7671705
States needing Special Attention,Below average state,HARYANA,25-29,0,UP,HARYANA,6,B0101,Total,Underperformance,0.477638254,167740,898329,1066069,43042,94681,137723,103985,118198,222183,26392,21567,47959,0.401328161,755502,140246,895748,109119,62173,171292,1,4,1053619,505,1178340,2231959
States needing Special Attention,Below average state,BIHAR,30-34,0,UP,BIHAR,10,B0101,Total,Underperformance,0.398690456,547586,2265469,2813055,291684,654264,945948,559859,836083,1395942,150640,125893,276533,0.364271939,2287056,283151,2570207,291611,111627,403238,1,4,3545141,446,3510596,7055737
States needing Special Attention,Below average state,HARYANA,30-34,0,UP,HARYANA,6,B0101,Total,Underperformance,0.519515566,166728,817022,983750,36700,69028,105728,100093,90254,190347,24388,15109,39497,0.359104474,625538,54459,679997,63775,19513,83288,1,4,916747,505,976844,1893591
States needing Special Attention,Below average state,BIHAR,35-39,0,UP,BIHAR,10,B0101,Total,Underperformance,0.427647419,522519,2238912,2761431,262369,595314,857683,511052,775334,1286386,136911,116267,253178,0.33392889,1978618,177648,2156266,230795,62705,293500,1,4,3149100,446,3308161,6457261
States needing Special Attention,Below average state,HARYANA,35-39,0,UP,HARYANA,6,B0101,Total,Underperformance,0.540188993,169463,782276,951739,32519,60199,92718,96419,80603,177022,23022,13258,36280,0.33874484,560242,36580,596822,45515,9926,55441,1,4,849146,505,912717,1761863
States needing Special Attention,Below average state,BIHAR,40-49,0,UP,BIHAR,10,B0101,Total,Underperformance,0.447832921,760392,3465389,4225781,349556,812028,1161584,722126,1111787,1833913,194399,169511,363910,0.319249781,2792346,220116,3012462,262239,62144,324383,1,4,4469263,446,4966803,9436066
States needing Special Attention,Below average state,HARYANA,40-49,0,UP,HARYANA,6,B0101,Total,Underperformance,0.54421486,253156,1242218,1495374,41974,80567,122541,143580,117211,260791,34311,19349,53660,0.341346273,870387,67552,937939,46652,12841,59493,1,4,1301434,505,1446330,2747764
States needing Special Attention,Below average state,BIHAR,5-Sep,0,UP,BIHAR,10,B0101,Total,Underperformance,0.010378965,68315,87746,156061,23083,28266,51349,71215,79271,150486,20786,21672,42458,0.976789135,7079602,7607670,14687272,60848,70573,131421,1,4,7239918,446,7796359,15036277
States needing Special Attention,Below average state,HARYANA,5-Sep,0,UP,HARYANA,6,B0101,Total,Underperformance,0.005849708,6015,8602,14617,1452,2035,3487,6219,7696,13915,1437,1771,3208,0.987297684,1113261,1353756,2467017,6263,8234,14497,1,4,1126932,505,1371825,2498757
States needing Special Attention,Below average state,BIHAR,50-59,0,UP,BIHAR,10,B0101,Total,Underperformance,0.435939561,469410,2193927,2663337,189487,429801,619288,440718,655465,1096183,127674,108636,236310,0.345955703,1932835,180753,2113588,125666,31377,157043,1,4,2970637,446,3138781,6109418
States needing Special Attention,Below average state,HARYANA,50-59,0,UP,HARYANA,6,B0101,Total,Underperformance,0.497882489,135181,719268,854449,17814,36295,54109,76214,62576,138790,20725,11710,32435,0.402345694,599149,91343,690492,18019,7831,25850,1,4,831269,505,884897,1716166
States needing Special Attention,Below average state,BIHAR,60-69,0,UP,BIHAR,10,B0101,Total,Underperformance,0.356202996,307877,1507970,1815847,111730,290728,402458,287251,523495,810746,95970,111225,207195,0.444114083,1743046,520953,2263999,77069,35260,112329,1,4,2434144,446,2663643,5097787
States needing Special Attention,Below average state,HARYANA,60-69,0,UP,HARYANA,6,B0101,Total,Underperformance,0.300792267,57031,348674,405705,7819,20279,28098,40877,45222,86099,14754,12090,26844,0.615471075,566898,263242,830140,9639,7462,17101,1,4,679560,505,669228,1348788
States needing Special Attention,Below average state,BIHAR,60+,0,UP,BIHAR,10,B0101,Total,Underperformance,0.325937945,409541,2102510,2512051,139752,385297,525049,371041,732167,1103208,127187,167919,295106,0.492631188,2692783,1103997,3796780,97912,51613,149525,1,4,3600552,446,4106593,7707145
States needing Special Attention,Below average state,HARYANA,60+,0,UP,HARYANA,6,B0101,Total,Underperformance,0.241559791,73239,456684,529923,9515,25191,34706,50246,60201,110447,18847,17733,36580,0.691419507,962802,554003,1516805,12772,10314,23086,1,4,1105134,505,1088621,2193755
States needing Special Attention,Below average state,BIHAR,70-79,0,UP,BIHAR,10,B0101,Total,Underperformance,0.286517168,77874,475107,552981,21452,76085,97537,64358,166168,230526,24315,44940,69255,0.558156693,681107,396141,1077248,15999,12492,28491,1,4,847654,446,1082356,1930010
States needing Special Attention,Below average state,HARYANA,70-79,0,UP,HARYANA,6,B0101,Total,Underperformance,0.167657238,11842,83786,95628,1235,3761,4996,7076,11620,18696,3174,4362,7536,0.786352209,262290,186228,448518,2187,2075,4262,1,4,284382,505,285996,570378
States needing Special Attention,Below average state,BIHAR,80+,0,UP,BIHAR,10,B0101,Total,Underperformance,0.210824202,23790,119433,143223,6570,18484,25054,19432,42504,61936,6902,11754,18656,0.670544404,268630,186903,455533,4844,3861,8705,1,4,318754,446,360594,679348
States needing Special Attention,Below average state,HARYANA,80+,0,UP,HARYANA,6,B0101,Total,Underperformance,0.104119247,4366,24224,28590,461,1151,1612,2293,3359,5652,919,1281,2200,0.867285288,133614,104533,238147,946,777,1723,1,4,141192,505,133397,274589
States needing Special Attention,Below average state,BIHAR,Age not stated,0,UP,BIHAR,10,B0101,Total,Underperformance,0.205027484,19009,63720,82729,7480,14937,22417,17671,26688,44359,3451,3934,7385,0.666735233,143062,125967,269029,4916,4783,9699,1,4,183193,446,220309,403502
States needing Special Attention,Below average state,HARYANA,Age not stated,0,UP,HARYANA,6,B0101,Total,Underperformance,0.232066975,1504,5814,7318,287,542,829,874,931,1805,205,156,361,0.699245259,12063,9987,22050,523,447,970,1,4,14646,505,16888,31534
States needing Special Attention,Below average state,BIHAR,Oct-14,0,UP,BIHAR,10,B0101,Total,Underperformance,0.021230712,101100,194429,295529,53288,95175,148463,132464,178339,310803,62051,71121,133172,0.946874262,6300436,6879942,13180378,112910,158403,271313,1,4,6596051,446,7323831,13919882
States needing Special Attention,Below average state,HARYANA,Oct-14,0,UP,HARYANA,6,B0101,Total,Underperformance,0.014567138,11715,27160,38875,4376,7918,12294,14284,17944,32228,9527,10832,20359,0.9657276,1159016,1418200,2577216,13395,21652,35047,1,4,1194542,505,1474136,2668678
States needing Special Attention,Below average state,BIHAR,Total,0,UP,BIHAR,10,B0101,Total,Underperformance,0.205184663,4088921,17270690,21359611,2053036,4899302,6952338,4194388,6728476,10922864,1219489,1223023,2442512,0.666424882,40318497,29055968,69374465,2431268,2077906,4509174,1,4,49821295,446,54278157,104099452
States needing Special Attention,Below average state,HARYANA,Total,0,UP,HARYANA,6,B0101,Total,Underperformance,0.276721043,1154683,5860600,7015283,260792,558852,819644,741466,769060,1510526,213723,176976,390699,0.648284269,9746856,6688098,16434954,579749,513841,1093590,1,4,11856728,505,13494734,25351462
Not considered,Below average state,INDIA,15-19,0,,,0,B0101,Urban,,0.121171385,929144,3508634,4437778,264444,555651,820095,479417,831239,1310656,80923,161953,242876,0.836410175,15722654,14910013,30632667,2109213,2713656,4822869,1,,17212138,558,19411839,36623977
Not considered,Below average state,INDIA,15-59,0,,,0,B0101,Urban,,0.437689591,19852337,87875855,107728192,2173988,4347622,6521610,4668331,7393116,12061447,866541,1252038,2118579,0.504698286,93168410,31052579,124220989,12384247,8439797,20824044,1,,118555619,558,127573588,246129207
Not considered,Below average state,INDIA,20-24,0,,,0,B0101,Urban,,0.311097961,2175693,9518223,11693916,417787,929008,1346795,708948,1318027,2026975,120413,238458,358871,0.625430416,15138091,8371323,23509414,3210789,3130005,6340794,1,,18143145,558,19446031,37589176
Not considered,Below average state,INDIA,25-29,0,,,0,B0101,Urban,,0.470380877,3060698,13565241,16625939,385447,801974,1187421,722777,1247710,1970487,125759,204400,330159,0.464529273,13468242,2950868,16419110,2526831,1391814,3918645,1,,17377476,558,17968219,35345695
Not considered,Below average state,INDIA,30-34,0,,,0,B0101,Urban,,0.533769716,2984839,13392909,16377748,308440,587943,896383,650287,997851,1648138,121037,157689,278726,0.403431562,11200527,1178033,12378560,1574010,497096,2071106,1,,14956690,558,15726482,30683172
Not considered,Below average state,INDIA,35-39,0,,,0,B0101,Urban,,0.556500784,3156089,13025828,16181917,291883,504618,796501,650789,893612,1544401,126945,141867,268812,0.381142299,10350334,732513,11082847,1254127,253732,1507859,1,,14284157,558,14793820,29077977
Not considered,Below average state,INDIA,40-49,0,,,0,B0101,Urban,,0.568781865,4882791,21558287,26441078,355334,665213,1020547,942707,1332585,2275292,185269,215570,400839,0.373651088,16222441,1147553,17369994,1267371,274499,1541870,1,,22233208,558,24253995,46487203
Not considered,Below average state,INDIA,5-Sep,0,,,0,B0101,Urban,,0.009087842,122461,178533,300994,42834,51914,94748,153384,174781,328165,8449,10051,18500,0.980445382,15361013,17111842,32472855,145070,169967,315037,1,,15645307,558,17475207,33120514
Not considered,Below average state,INDIA,50-59,0,,,0,B0101,Urban,,0.526674108,2663083,13306733,15969816,150653,303215,453868,513406,772092,1285498,106195,132101,238296,0.42307216,11066121,1762276,12828397,441906,178995,620901,1,,14348805,558,15973202,30322007
Not considered,Below average state,INDIA,60-69,0,,,0,B0101,Urban,,0.292413824,960925,4568964,5529889,69808,145881,215689,268653,440321,708974,62748,91676,154424,0.661930737,8112677,4405211,12517888,201969,171347,373316,1,,9405003,558,9506172,18911175
Not considered,Below average state,INDIA,60+,0,,,0,B0101,Urban,,0.244396293,1289017,6178565,7467582,94767,196575,291342,376872,631320,1008192,86197,134745,220942,0.715377059,13728562,8129940,21858502,272986,230168,503154,1,,15480648,558,15074570,30555218
Not considered,Below average state,INDIA,70-79,0,,,0,B0101,Urban,,0.177099641,240364,1220713,1461077,16591,35858,52449,76632,141807,218439,17855,32911,50766,0.79026956,3864678,2655068,6519746,47675,41802,89477,1,,4199529,558,4050499,8250028
Not considered,Below average state,INDIA,80+,0,,,0,B0101,Urban,,0.140428372,87728,388888,476616,8368,14836,23204,31587,49192,80779,5594,10158,15752,0.831130092,1751207,1069661,2820868,23342,17019,40361,1,,1876116,558,1517899,3394015
Not considered,Below average state,INDIA,Age not stated,0,,,0,B0101,Urban,,0.264623339,78351,338788,417139,11408,20993,32401,34502,53687,88189,3300,5892,9192,0.673600406,620736,441094,1061830,21808,22350,44158,1,,736889,558,839461,1576350
Not considered,Below average state,INDIA,Oct-14,0,,,0,B0101,Urban,,0.021814487,240338,542905,783243,82389,121794,204183,234346,292098,526444,28488,40488,68976,0.961602177,16470869,18055186,34526055,331821,437177,768998,1,,16974041,558,18930677,35904718
Not considered,Below average state,INDIA,Total,0,,,0,B0101,Urban,,0.309454401,21582504,95114646,116697150,2405386,4738898,7144284,5467435,8545002,14012437,992975,1443214,2436189,0.64692757,153574011,90386338,243960349,13155932,9299459,22455391,1,,181616925,558,195489200,377106125
Can be easily improved,Below average state,ARUNACHAL PRADESH,15-19,0,UP,ARUNACHAL PRADESH,12,B0101,Urban,Underperformance,0.076734162,1079,1983,3062,529,539,1068,895,923,1818,100,137,237,0.871767241,18118,16669,34787,3283,2831,6114,1,3,20192,563,19712,39904
Can be easily improved,Below average state,WEST BENGAL,15-19,0,UP,WEST BENGAL,19,B0101,Urban,Underperformance,0.125251975,73453,254123,327576,46476,78986,125462,54656,82546,137202,10131,17502,27633,0.811721706,1134375,988550,2122925,460678,462133,922811,1,3,1272615,560,1342721,2615336
Can be easily improved,Below average state,ARUNACHAL PRADESH,15-59,0,UP,ARUNACHAL PRADESH,12,B0101,Urban,Underperformance,0.464725187,23306,74547,97853,3000,3604,6604,5915,6246,12161,654,923,1577,0.470030063,66759,32211,98970,14077,8850,22927,1,3,96634,563,113927,210561
Can be easily improved,Below average state,WEST BENGAL,15-59,0,UP,WEST BENGAL,19,B0101,Urban,Underperformance,0.432550973,1417695,7062222,8479917,350256,537741,887997,465013,615857,1080870,92652,128581,221233,0.501030226,7543927,2278487,9822414,2808644,1275803,4084447,1,3,9519287,560,10085147,19604434
Can be easily improved,Below average state,ARUNACHAL PRADESH,20-24,0,UP,ARUNACHAL PRADESH,12,B0101,Urban,Underperformance,0.28649608,2516,7169,9685,753,850,1603,1149,1180,2329,128,194,322,0.635083568,13002,8467,21469,4286,3316,7602,1,3,16795,563,17010,33805
Can be easily improved,Below average state,WEST BENGAL,20-24,0,UP,WEST BENGAL,19,B0101,Urban,Underperformance,0.285551891,141749,633696,775445,65205,115548,180753,76325,117706,194031,13601,23744,37345,0.629245607,1123968,584812,1708780,594067,416295,1010362,1,3,1355643,560,1359958,2715601
Can be easily improved,Below average state,ARUNACHAL PRADESH,25-29,0,UP,ARUNACHAL PRADESH,12,B0101,Urban,Underperformance,0.526705915,4543,12724,17267,633,767,1400,1078,1193,2271,116,171,287,0.395265839,9654,3304,12958,2776,1617,4393,1,3,15391,563,17392,32783
Can be easily improved,Below average state,WEST BENGAL,25-29,0,UP,WEST BENGAL,19,B0101,Urban,Underperformance,0.437183517,204138,951300,1155438,60987,98096,159083,73744,104224,177968,13880,21003,34883,0.482279969,1029742,244882,1274624,506409,185247,691656,1,3,1321504,560,1321409,2642913
Can be easily improved,Below average state,ARUNACHAL PRADESH,30-34,0,UP,ARUNACHAL PRADESH,12,B0101,Urban,Underperformance,0.616689609,4333,12243,16576,390,464,854,822,816,1638,87,147,234,0.313664943,7181,1250,8431,1490,516,2006,1,3,12423,563,14456,26879
Can be easily improved,Below average state,WEST BENGAL,30-34,0,UP,WEST BENGAL,19,B0101,Urban,Underperformance,0.505247518,204528,1002670,1207198,50546,70326,120872,64863,78587,143450,12649,15927,28576,0.422754591,897804,112292,1010096,387011,76165,463176,1,3,1179844,560,1209476,2389320
Can be easily improved,Below average state,ARUNACHAL PRADESH,35-39,0,UP,ARUNACHAL PRADESH,12,B0101,Urban,Underperformance,0.630432199,4136,11778,15914,339,380,719,770,733,1503,87,92,179,0.302935467,6865,782,7647,1143,245,1388,1,3,11858,563,13385,25243
Can be easily improved,Below average state,WEST BENGAL,35-39,0,UP,WEST BENGAL,19,B0101,Urban,Underperformance,0.530584099,222743,1059119,1281862,48832,59506,108338,65087,69313,134400,13237,14154,27391,0.402447903,897594,74698,972292,344799,45116,389915,1,3,1198661,560,1217284,2415945
Can be easily improved,Below average state,ARUNACHAL PRADESH,40-49,0,UP,ARUNACHAL PRADESH,12,B0101,Urban,Underperformance,0.676024919,5072,19778,24850,277,450,727,892,964,1856,109,129,238,0.26700944,8748,1067,9815,889,245,1134,1,3,14821,563,21938,36759
Can be easily improved,Below average state,WEST BENGAL,40-49,0,UP,WEST BENGAL,19,B0101,Urban,Underperformance,0.554461124,358507,1882387,2240894,57222,79674,136896,88012,103380,191392,18796,22159,40955,0.388049598,1450571,117759,1568330,385394,53929,439323,1,3,1915886,560,2125685,4041571
Can be easily improved,Below average state,ARUNACHAL PRADESH,5-Sep,0,UP,ARUNACHAL PRADESH,12,B0101,Urban,Underperformance,0.005644546,96,89,185,121,128,249,314,321,635,23,18,41,0.973729977,15880,16034,31914,351,345,696,1,3,16313,563,16462,32775
Can be easily improved,Below average state,WEST BENGAL,5-Sep,0,UP,WEST BENGAL,19,B0101,Urban,Underperformance,0.008309514,7596,10678,18274,4579,5131,9710,9304,10126,19430,1233,1286,2519,0.981709885,1049628,1109315,2158943,26906,29469,56375,1,3,1067761,560,1131405,2199166
Can be easily improved,Below average state,ARUNACHAL PRADESH,50-59,0,UP,ARUNACHAL PRADESH,12,B0101,Urban,Underperformance,0.691269423,1627,8872,10499,79,154,233,309,437,746,27,53,80,0.254345536,3191,672,3863,210,80,290,1,3,5154,563,10034,15188
Can be easily improved,Below average state,WEST BENGAL,50-59,0,UP,WEST BENGAL,19,B0101,Urban,Underperformance,0.535789878,212577,1278927,1491504,20988,35605,56593,42326,60101,102427,10358,14092,24450,0.418632362,1009873,155494,1165367,130286,36918,167204,1,3,1275134,560,1508614,2783748
Can be easily improved,Below average state,ARUNACHAL PRADESH,60-69,0,UP,ARUNACHAL PRADESH,12,B0101,Urban,Underperformance,0.392307692,298,1589,1887,20,56,76,95,156,251,19,24,43,0.546569647,1678,951,2629,72,67,139,1,3,2090,563,2720,4810
Can be easily improved,Below average state,WEST BENGAL,60-69,0,UP,WEST BENGAL,19,B0101,Urban,Underperformance,0.268880169,66300,391223,457523,7414,13935,21349,18969,30928,49897,5419,8757,14176,0.693464983,720599,459392,1179991,47837,38206,86043,1,3,811287,560,890300,1701587
Can be easily improved,Below average state,ARUNACHAL PRADESH,60+,0,UP,ARUNACHAL PRADESH,12,B0101,Urban,Underperformance,0.347210772,412,2115,2527,39,79,118,147,221,368,29,45,74,0.592058258,2706,1603,4309,105,104,209,1,3,3294,563,3984,7278
Can be easily improved,Below average state,WEST BENGAL,60+,0,UP,WEST BENGAL,19,B0101,Urban,Underperformance,0.218258898,91660,529440,621100,10764,19111,29875,27856,45388,73244,7984,13006,20990,0.748626614,1258234,872135,2130369,66931,51966,118897,1,3,1385734,560,1459969,2845703
Can be easily improved,Below average state,ARUNACHAL PRADESH,70-79,0,UP,ARUNACHAL PRADESH,12,B0101,Urban,Underperformance,0.247972973,57,310,367,7,16,23,21,41,62,8,18,26,0.692567568,643,382,1025,14,17,31,1,3,729,563,751,1480
Can be easily improved,Below average state,WEST BENGAL,70-79,0,UP,WEST BENGAL,19,B0101,Urban,Underperformance,0.145938727,17173,99200,116373,1800,3154,4954,5621,10017,15638,1774,3115,4889,0.828319183,364464,296046,660510,11223,9667,20890,1,3,389032,560,408378,797410
Can be easily improved,Below average state,ARUNACHAL PRADESH,80+,0,UP,ARUNACHAL PRADESH,12,B0101,Urban,Underperformance,0.276315789,57,216,273,12,7,19,31,24,55,2,3,5,0.662955466,385,270,655,19,20,39,1,3,475,563,513,988
Can be easily improved,Below average state,WEST BENGAL,80+,0,UP,WEST BENGAL,19,B0101,Urban,Underperformance,0.136149937,8187,39017,47204,1550,2022,3572,3266,4443,7709,791,1134,1925,0.836062831,173171,116697,289868,7871,4093,11964,1,3,185415,560,161291,346706
Can be easily improved,Below average state,ARUNACHAL PRADESH,Age not stated,0,UP,ARUNACHAL PRADESH,12,B0101,Urban,Underperformance,0.335443038,20,86,106,1,5,6,3,15,18,2,5,7,0.585443038,93,92,185,9,7,16,1,3,118,563,198,316
Can be easily improved,Below average state,WEST BENGAL,Age not stated,0,UP,WEST BENGAL,19,B0101,Urban,Underperformance,0.235508038,2729,12360,15089,953,951,1904,1606,1677,3283,231,275,506,0.70535352,22119,23073,45192,2236,1967,4203,1,3,26685,560,37385,64070
Can be easily improved,Below average state,ARUNACHAL PRADESH,Oct-14,0,UP,ARUNACHAL PRADESH,12,B0101,Urban,Underperformance,0.016830651,319,343,662,224,206,430,560,464,1024,59,45,104,0.95449114,18936,18607,37543,838,727,1565,1,3,19874,563,19459,39333
Can be easily improved,Below average state,WEST BENGAL,Oct-14,0,UP,WEST BENGAL,19,B0101,Urban,Underperformance,0.025314296,19101,43664,62765,12874,17725,30599,20524,25113,45637,3823,5194,9017,0.952642725,1159503,1202507,2362010,85589,99660,185249,1,3,1202951,560,1276478,2479429
Can be easily improved,Below average state,ARUNACHAL PRADESH,Total,0,UP,ARUNACHAL PRADESH,12,B0101,Urban,Underperformance,0.319290794,24153,77180,101333,3385,4022,7407,6939,7267,14206,767,1036,1803,0.630266346,117609,82418,200027,15380,10033,25413,1,3,149468,563,167901,317369
Can be easily improved,Below average state,WEST BENGAL,Total,0,UP,WEST BENGAL,19,B0101,Urban,Underperformance,0.316129116,1538781,7658364,9197145,379426,580659,960085,524303,698161,1222464,105923,148342,254265,0.633111977,11959913,6459215,18419128,2990306,1458865,4449171,1,3,14128920,560,14964082,29093002
Not considered,Below average state,ASSAM,15-19,0,UP,ASSAM,18,B0101,Urban,Underperformance,0.098113674,6998,32688,39686,5353,9051,14404,7536,11724,19260,1033,2148,3181,0.846406586,181926,160437,342363,50973,52536,103509,1,4,197493,516,206997,404490
Not considered,Below average state,CHANDIGARH,15-19,0,UP,CHANDIGARH,4,B0101,Urban,Underperformance,0.14756082,2262,12738,15000,320,757,1077,555,1182,1737,89,281,370,0.831711804,40013,44533,84546,4178,5587,9765,1,4,42919,538,58734,101653
Not considered,Below average state,DADRA & NAGAR HAVELI,15-19,0,UP,DADRA & NAGAR HAVELI,26,B0101,Urban,Underperformance,0.363565396,514,4609,5123,34,77,111,128,267,395,13,76,89,0.602086438,4232,4252,8484,187,323,510,1,4,4887,523,9204,14091
Not considered,Below average state,DELHI,15-19,0,UP,DELHI,7,B0101,Urban,Underperformance,0.099637833,20990,140723,161713,2513,8885,11398,5269,14271,19540,1000,3709,4709,0.88542139,695547,741499,1437046,39529,79567,119096,1,4,722806,500,900202,1623008
Not considered,Below average state,GOA,15-19,0,UP,GOA,30,B0101,Urban,Underperformance,0.138383867,2677,7218,9895,742,1043,1785,1125,1695,2820,152,397,549,0.814499888,29475,28765,58240,5446,5587,11033,1,4,33429,535,38075,71504
Not considered,Below average state,JAMMU & KASHMIR,15-19,0,UP,JAMMU & KASHMIR,1,B0101,Urban,Underperformance,0.057217829,3495,14320,17815,6137,8146,14283,7147,9347,16494,2397,2371,4768,0.874493342,135051,137226,272277,40286,42428,82714,1,4,148090,524,163264,311354
Not considered,Below average state,JHARKHAND,15-19,0,UP,JHARKHAND,20,B0101,Urban,Underperformance,0.070083851,10536,48748,59284,5437,15921,21358,7961,19094,27055,2057,4342,6399,0.890367785,378781,374382,753163,51189,74775,125964,1,4,399335,529,446566,845901
Not considered,Below average state,KERALA,15-19,0,UP,KERALA,32,B0101,Urban,Underperformance,0.044331382,10629,44552,55181,8037,14305,22342,9371,16149,25520,997,3700,4697,0.931392846,591647,567694,1159341,165896,168804,334700,1,4,612644,539,632095,1244739
Not considered,Below average state,LAKSHADWEEP,15-19,0,UP,LAKSHADWEEP,31,B0101,Urban,Underperformance,0.008934554,9,31,40,42,86,128,34,64,98,11,39,50,0.958007594,2140,2149,4289,924,949,1873,1,4,2194,528,2283,4477
Not considered,Below average state,MADHYA PRADESH,15-19,0,UP,MADHYA PRADESH,23,B0101,Urban,Underperformance,0.121067392,47093,205583,252676,13540,36482,50022,23215,48551,71766,5421,11282,16703,0.836543497,893615,852309,1745924,97955,138354,236309,1,3,969344,554,1117725,2087069
Not considered,Below average state,MANIPUR,15-19,0,UP,MANIPUR,14,B0101,Urban,Underperformance,0.069772472,1974,3187,5161,1734,1545,3279,2377,1848,4225,824,622,1446,0.853560275,32205,30932,63137,8175,8333,16508,1,3,37380,551,36589,73969
Not considered,Below average state,NAGALAND,15-19,0,UP,NAGALAND,13,B0101,Urban,Underperformance,0.073549397,1321,3658,4979,873,1056,1929,1450,1685,3135,1003,1045,2048,0.849887733,29287,28247,57534,4899,4957,9856,1,3,33061,567,34635,67696
Not considered,Below average state,ODISHA,15-19,0,UP,ODISHA,21,B0101,Urban,Underperformance,0.107193675,15617,57835,73452,7672,14797,22469,11930,19860,31790,2293,3593,5886,0.837823086,299692,274407,574099,57471,74328,131799,1,3,329532,558,355695,685227
Not considered,Below average state,PUDUCHERRY,15-19,0,UP,PUDUCHERRY,34,B0101,Urban,Underperformance,0.07315109,1419,3577,4996,187,334,521,284,508,792,57,123,180,0.912616952,31700,30629,62329,3194,3635,6829,1,4,33460,493,34837,68297
Not considered,Below average state,PUNJAB,15-19,0,UP,PUNJAB,3,B0101,Urban,Underperformance,0.132383958,19736,113079,132815,6876,16012,22888,13083,24843,37926,1223,4089,5312,0.824518368,402865,424338,827203,49004,78923,127927,1,3,436907,556,566349,1003256
Not considered,Below average state,UTTAR PRADESH,15-19,0,UP,UTTAR PRADESH,9,B0101,Urban,Underperformance,0.117164858,109244,507195,616439,47403,125884,173287,93308,190487,283795,13897,33152,47049,0.819952536,2230692,2083321,4314013,256366,412466,668832,1,4,2447141,507,2814155,5261296
Not considered,Below average state,UTTARAKHAND,15-19,0,UP,UTTARAKHAND,5,B0101,Urban,Underperformance,0.107505163,4420,31187,35607,1623,5279,6902,3021,7825,10846,582,1514,2096,0.853420166,141775,140888,282663,13794,21521,35315,1,4,149798,544,181414,331212
Not considered,Below average state,ASSAM,15-59,0,UP,ASSAM,18,B0101,Urban,Underperformance,0.423560251,206387,1066869,1273256,40264,62893,103157,74056,98595,172651,11097,16061,27158,0.509971458,1170311,362704,1533015,298786,167842,466628,1,4,1461851,516,1544229,3006080
Not considered,Below average state,CHANDIGARH,15-59,0,UP,CHANDIGARH,4,B0101,Urban,Underperformance,0.510615206,64514,293992,358506,2567,4722,7289,5155,7811,12966,943,1674,2617,0.467190139,242538,85479,328017,27192,17661,44853,1,4,313150,538,388956,702106
Not considered,Below average state,DADRA & NAGAR HAVELI,15-59,0,UP,DADRA & NAGAR HAVELI,26,B0101,Urban,Underperformance,0.594025267,6926,59230,66156,306,437,743,1994,2055,4049,177,339,516,0.36498487,33091,7557,40648,2174,983,3157,1,4,42188,523,69181,111369
Not considered,Below average state,DELHI,15-59,0,UP,DELHI,7,B0101,Urban,Underperformance,0.455402779,692897,4223033,4915930,25018,81947,106965,57915,146544,204459,10429,28068,38497,0.522090221,4233242,1402558,5635800,286177,293318,579495,1,4,4994483,500,5800203,10794686
Not considered,Below average state,GOA,15-59,0,UP,GOA,30,B0101,Urban,Underperformance,0.475068144,70453,218692,289145,7214,12318,19532,13614,23332,36946,2492,4913,7405,0.452062717,207424,67719,275143,39041,21535,60576,1,4,293983,535,314656,608639
Not considered,Below average state,JAMMU & KASHMIR,15-59,0,UP,JAMMU & KASHMIR,1,B0101,Urban,Underperformance,0.406019695,114466,794673,909139,47272,68843,116115,68520,92944,161464,23422,18014,41436,0.503365563,803314,323797,1127111,224649,138367,363016,1,4,1009722,524,1229428,2239150
Not considered,Below average state,JHARKHAND,15-59,0,UP,JHARKHAND,20,B0101,Urban,Underperformance,0.359134277,240142,1550114,1790256,49802,159533,209335,82377,205732,288109,23006,35597,58603,0.571313567,2029123,818830,2847953,267630,274579,542209,1,4,2374648,529,2610273,4984921
Not considered,Below average state,KERALA,15-59,0,UP,KERALA,32,B0101,Urban,Underperformance,0.396961851,901899,3156974,4058873,174312,242048,416360,256347,375588,631935,76537,67450,143987,0.527152199,4158454,1231595,5390049,1271745,505682,1777427,1,4,5393237,539,4831607,10224844
Not considered,Below average state,LAKSHADWEEP,15-59,0,UP,LAKSHADWEEP,31,B0101,Urban,Underperformance,0.246550083,1289,7001,8290,958,3014,3972,683,2579,3262,522,1477,1999,0.596984297,13685,6388,20073,5243,4060,9303,1,4,16179,528,17445,33624
Not considered,Below average state,MADHYA PRADESH,15-59,0,UP,MADHYA PRADESH,23,B0101,Urban,Underperformance,0.430184885,1000329,4508219,5508548,137207,285907,423114,257649,402437,660086,52269,70011,122280,0.508716976,4802334,1711823,6514157,556179,453202,1009381,1,3,6112581,554,6692490,12805071
Not considered,Below average state,MANIPUR,15-59,0,UP,MANIPUR,14,B0101,Urban,Underperformance,0.441999016,79690,156604,236294,19189,15620,34809,36419,23063,59482,9867,4992,14859,0.418942655,147439,76529,223968,43297,31183,74480,1,3,273415,551,261188,534603
Not considered,Below average state,NAGALAND,15-59,0,UP,NAGALAND,13,B0101,Urban,Underperformance,0.442231354,45174,119482,164656,6312,6500,12812,15366,11559,26925,4303,3066,7369,0.465662181,110510,62870,173380,22885,18652,41537,1,3,175353,567,196977,372330
Not considered,Below average state,ODISHA,15-59,0,UP,ODISHA,21,B0101,Urban,Underperformance,0.414357873,311569,1633835,1945404,50358,104516,154874,104808,162631,267439,19958,25003,44961,0.519103043,1829024,608157,2437181,269417,238670,508087,1,3,2265359,558,2429626,4694985
Not considered,Below average state,PUDUCHERRY,15-59,0,UP,PUDUCHERRY,34,B0101,Urban,Underperformance,0.460960473,58862,203708,262570,2683,4509,7192,5558,8653,14211,1384,1932,3316,0.508269621,224770,64748,289518,28908,15603,44511,1,4,290574,493,279041,569615
Not considered,Below average state,PUNJAB,15-59,0,UP,PUNJAB,3,B0101,Urban,Underperformance,0.442856903,458957,2606231,3065188,47981,93833,141814,102891,164768,267659,13511,27464,40975,0.512551803,2674105,873469,3547574,309454,217938,527392,1,3,3249464,556,3671932,6921396
Not considered,Below average state,UTTAR PRADESH,15-59,0,UP,UTTAR PRADESH,9,B0101,Urban,Underperformance,0.359560463,1286976,8578050,9865026,260383,830422,1090805,612501,1369272,1981773,93926,223551,317477,0.556636474,10999152,4272920,15272072,1116477,1151891,2268368,1,4,12992555,507,14443793,27436348
Not considered,Below average state,UTTARAKHAND,15-59,0,UP,UTTARAKHAND,5,B0101,Urban,Underperformance,0.411228413,116177,695050,811227,12479,37352,49831,26292,58162,84454,4610,9005,13615,0.539058302,783413,279983,1063396,84061,71332,155393,1,4,930492,544,1042200,1972692
Not considered,Below average state,ASSAM,20-24,0,UP,ASSAM,18,B0101,Urban,Underperformance,0.242268447,16915,87697,104612,8973,14870,23843,12125,18680,30805,1598,3258,4856,0.67514509,188695,102834,291529,76243,60638,136881,1,4,219333,516,212469,431802
Not considered,Below average state,CHANDIGARH,20-24,0,UP,CHANDIGARH,4,B0101,Urban,Underperformance,0.372704014,6722,37127,43849,736,1413,2149,1030,1965,2995,227,478,705,0.595847039,43460,26642,70102,8438,7776,16214,1,4,51439,538,66212,117651
Not considered,Below average state,DADRA & NAGAR HAVELI,20-24,0,UP,DADRA & NAGAR HAVELI,26,B0101,Urban,Underperformance,0.585095445,1002,12086,13088,68,111,179,340,505,845,29,90,119,0.3718092,6469,1848,8317,683,389,1072,1,4,7840,523,14529,22369
Not considered,Below average state,DELHI,20-24,0,UP,DELHI,7,B0101,Urban,Underperformance,0.32741431,80968,482071,563039,5798,19680,25478,10372,29546,39918,2007,6914,8921,0.644185193,698700,409075,1107775,89671,124911,214582,1,4,792047,500,927606,1719653
Not considered,Below average state,GOA,20-24,0,UP,GOA,30,B0101,Urban,Underperformance,0.422551075,9287,25977,35264,1494,2554,4048,2152,3819,5971,362,975,1337,0.489880774,25628,15255,40883,8582,7063,15645,1,4,37429,535,46026,83455
Not considered,Below average state,JAMMU & KASHMIR,20-24,0,UP,JAMMU & KASHMIR,1,B0101,Urban,Underperformance,0.238805344,9052,70602,79654,10322,13675,23997,11587,15359,26946,3756,3436,7192,0.658847796,128871,90889,219760,59331,49952,109283,1,4,153266,524,180286,333552
Not considered,Below average state,JHARKHAND,20-24,0,UP,JHARKHAND,20,B0101,Urban,Underperformance,0.20071244,22249,133376,155625,8573,28787,37360,12067,33444,45511,3239,6280,9519,0.728314351,337629,227079,564708,74335,96846,171181,1,4,375184,529,400179,775363
Not considered,Below average state,KERALA,20-24,0,UP,KERALA,32,B0101,Urban,Underperformance,0.239308833,58316,247939,306255,24441,48038,72479,25591,52114,77705,4853,11188,16041,0.687437683,572445,307302,879747,297150,196863,494013,1,4,661205,539,618543,1279748
Not considered,Below average state,LAKSHADWEEP,20-24,0,UP,LAKSHADWEEP,31,B0101,Urban,Underperformance,0.081116729,56,313,369,145,420,565,89,282,371,70,222,292,0.773136953,1943,1574,3517,1303,1261,2564,1,4,2158,528,2391,4549
Not considered,Below average state,MADHYA PRADESH,20-24,0,UP,MADHYA PRADESH,23,B0101,Urban,Underperformance,0.294220088,98109,504695,602804,21946,60394,82340,35544,76893,112437,7206,14552,21758,0.640281235,835501,476320,1311821,159952,174651,334603,1,3,976360,554,1072460,2048820
Not considered,Below average state,MANIPUR,20-24,0,UP,MANIPUR,14,B0101,Urban,Underperformance,0.251015667,6802,12537,19339,3583,3106,6689,5040,3480,8520,1463,911,2374,0.607582778,26374,20436,46810,10915,10443,21358,1,3,39679,551,37364,77043
Not considered,Below average state,NAGALAND,20-24,0,UP,NAGALAND,13,B0101,Urban,Underperformance,0.249945973,4615,11577,16192,1527,1669,3196,2410,2246,4656,922,786,1708,0.651816863,24010,18216,42226,7320,6708,14028,1,3,31957,567,32825,64782
Not considered,Below average state,ODISHA,20-24,0,UP,ODISHA,21,B0101,Urban,Underperformance,0.258686212,32622,149669,182291,10496,24329,34825,16316,30931,47247,2717,4958,7675,0.663374865,295749,171718,467467,78403,89075,167478,1,3,347404,558,357276,704680
Not considered,Below average state,PUDUCHERRY,20-24,0,UP,PUDUCHERRY,34,B0101,Urban,Underperformance,0.292596524,6027,15200,21227,540,913,1453,786,1219,2005,169,263,432,0.67381146,31433,17450,48883,7555,6517,14072,1,4,38415,493,34132,72547
Not considered,Below average state,PUNJAB,20-24,0,UP,PUNJAB,3,B0101,Urban,Underperformance,0.329155929,49498,302634,352132,10653,22710,33363,17587,33203,50790,2026,5898,7924,0.615961069,423900,235057,658957,83363,81605,164968,1,3,493011,556,576792,1069803
Not considered,Below average state,UTTAR PRADESH,20-24,0,UP,UTTAR PRADESH,9,B0101,Urban,Underperformance,0.258232301,153657,1031527,1185184,53834,173282,227116,100799,252904,353703,14572,41288,55860,0.652530589,1842792,1152065,2994857,298255,401598,699853,1,4,2111820,507,2477784,4589604
Not considered,Below average state,UTTARAKHAND,20-24,0,UP,UTTARAKHAND,5,B0101,Urban,Underperformance,0.28271245,11450,79595,91045,3009,8308,11317,4602,11445,16047,650,1868,2518,0.659639611,133156,79275,212431,25852,28193,54045,1,4,149858,544,172183,322041
Not considered,Below average state,ASSAM,25-29,0,UP,ASSAM,18,B0101,Urban,Underperformance,0.406395155,29566,144630,174196,8544,13330,21874,12882,18368,31250,1827,2957,4784,0.509538374,174383,44024,218407,62588,30231,92819,1,4,218658,516,209979,428637
Not considered,Below average state,CHANDIGARH,25-29,0,UP,CHANDIGARH,4,B0101,Urban,Underperformance,0.576260676,11023,50309,61332,549,944,1493,918,1495,2413,174,296,470,0.396651352,35882,6334,42216,6498,2731,9229,1,4,47997,538,58434,106431
Not considered,Below average state,DADRA & NAGAR HAVELI,25-29,0,UP,DADRA & NAGAR HAVELI,26,B0101,Urban,Underperformance,0.608781717,1261,12271,13532,75,81,156,430,395,825,33,75,108,0.349244197,7263,500,7763,634,121,755,1,4,8987,523,13241,22228
Not considered,Below average state,DELHI,25-29,0,UP,DELHI,7,B0101,Urban,Underperformance,0.513794323,122037,714973,837010,4813,15780,20593,9858,27199,37057,1648,5159,6807,0.459279984,637921,110281,748202,65263,50288,115551,1,4,771464,500,857612,1629076
Not considered,Below average state,GOA,25-29,0,UP,GOA,30,B0101,Urban,Underperformance,0.527657208,11737,31905,43642,1411,2349,3760,2201,3788,5989,355,834,1189,0.38555659,25922,5967,31889,7618,3363,10981,1,4,40215,535,42494,82709
Not considered,Below average state,JAMMU & KASHMIR,25-29,0,UP,JAMMU & KASHMIR,1,B0101,Urban,Underperformance,0.449023749,18281,137779,156060,9705,13151,22856,12169,16435,28604,3728,2967,6695,0.449412178,114361,41834,156195,49101,26742,75843,1,4,148539,524,199015,347554
Not considered,Below average state,JHARKHAND,25-29,0,UP,JHARKHAND,20,B0101,Urban,Underperformance,0.357419636,34289,219554,253843,8584,30636,39220,12919,37236,50155,3632,6343,9975,0.557915264,293950,102287,396237,56017,57025,113042,1,4,344790,529,365420,710210
Not considered,Below average state,KERALA,25-29,0,UP,KERALA,32,B0101,Urban,Underperformance,0.413921312,99154,412062,511216,27225,45991,73216,29852,56209,86061,6893,9684,16577,0.502974764,534218,86984,621202,256821,62678,319499,1,4,670117,539,564939,1235056
Not considered,Below average state,LAKSHADWEEP,25-29,0,UP,LAKSHADWEEP,31,B0101,Urban,Underperformance,0.184684685,160,701,861,226,651,877,151,488,639,102,292,394,0.593736594,1796,972,2768,1004,812,1816,1,4,2209,528,2453,4662
Not considered,Below average state,MADHYA PRADESH,25-29,0,UP,MADHYA PRADESH,23,B0101,Urban,Underperformance,0.450634181,137535,672096,809631,22128,51850,73978,37858,69729,107587,7716,11999,19715,0.478510537,692668,167047,859715,114258,80501,194759,1,3,875777,554,920871,1796648
Not considered,Below average state,MANIPUR,25-29,0,UP,MANIPUR,14,B0101,Urban,Underperformance,0.426522858,11797,23003,34800,4301,3458,7759,6539,4290,10829,1748,931,2679,0.407917637,22244,11038,33282,9407,6694,16101,1,3,42328,551,39262,81590
Not considered,Below average state,NAGALAND,25-29,0,UP,NAGALAND,13,B0101,Urban,Underperformance,0.47035302,7958,20155,28113,1454,1408,2862,2800,2215,5015,698,456,1154,0.426434666,17304,8184,25488,5403,4374,9777,1,3,28760,567,31010,59770
Not considered,Below average state,ODISHA,25-29,0,UP,ODISHA,21,B0101,Urban,Underperformance,0.413492467,45178,225679,270857,8913,20303,29216,15838,28113,43951,2863,4100,6963,0.508781813,264676,68600,333276,54544,43635,98179,1,3,328555,558,326492,655047
Not considered,Below average state,PUDUCHERRY,25-29,0,UP,PUDUCHERRY,34,B0101,Urban,Underperformance,0.479270566,8853,29203,38056,553,936,1489,896,1452,2348,176,258,434,0.485693416,32869,5697,38566,7035,2985,10020,1,4,42794,493,36610,79404
Not considered,Below average state,PUNJAB,25-29,0,UP,PUNJAB,3,B0101,Urban,Underperformance,0.493996956,74493,423656,498149,8733,16850,25583,16395,27366,43761,2005,4659,6664,0.455998334,383303,76528,459831,65680,31168,96848,1,3,476196,556,532209,1008405
Not considered,Below average state,UTTAR PRADESH,25-29,0,UP,UTTAR PRADESH,9,B0101,Urban,Underperformance,0.385309349,182942,1250062,1433004,40690,137963,178653,86771,216383,303154,12249,34405,46654,0.520633487,1502223,434065,1936288,205846,176034,381880,1,4,1784185,507,1934915,3719100
Not considered,Below average state,UTTARAKHAND,25-29,0,UP,UTTARAKHAND,5,B0101,Urban,Underperformance,0.441710944,16789,107080,123869,2377,6756,9133,4222,9922,14144,662,1485,2147,0.500196127,114671,25599,140270,19414,12420,31834,1,4,136344,544,144086,280430
Not considered,Below average state,ASSAM,30-34,0,UP,ASSAM,18,B0101,Urban,Underperformance,0.485610301,30029,154770,184799,6018,8930,14948,10863,13883,24746,1640,2087,3727,0.439569045,148391,18887,167278,41450,12062,53512,1,4,190923,516,189627,380550
Not considered,Below average state,CHANDIGARH,30-34,0,UP,CHANDIGARH,4,B0101,Urban,Underperformance,0.622859228,9673,44953,54626,322,536,858,739,933,1672,128,171,299,0.35466694,29439,1666,31105,3240,680,3920,1,4,39979,538,47723,87702
Not considered,Below average state,DADRA & NAGAR HAVELI,30-34,0,UP,DADRA & NAGAR HAVELI,26,B0101,Urban,Underperformance,0.648993786,1272,10112,11384,48,57,105,347,276,623,31,33,64,0.31184083,5256,214,5470,338,51,389,1,4,6906,523,10635,17541
Not considered,Below average state,DELHI,30-34,0,UP,DELHI,7,B0101,Urban,Underperformance,0.561498387,104430,682154,786584,3573,10973,14546,8233,20145,28378,1517,3338,4855,0.41477843,546662,34387,581049,36428,15737,52165,1,4,660842,500,740024,1400866
Not considered,Below average state,GOA,30-34,0,UP,GOA,30,B0101,Urban,Underperformance,0.53795992,9933,31810,41743,1022,1851,2873,1761,3354,5115,293,630,923,0.384225788,26347,3467,29814,6068,1791,7859,1,4,38334,535,39261,77595
Not considered,Below average state,JAMMU & KASHMIR,30-34,0,UP,JAMMU & KASHMIR,1,B0101,Urban,Underperformance,0.511971826,18991,129873,148864,6816,10132,16948,9889,13468,23357,3216,2322,5538,0.388652731,95986,17021,113007,29443,9924,39367,1,4,128082,524,162684,290766
Not considered,Below average state,JHARKHAND,30-34,0,UP,JHARKHAND,20,B0101,Urban,Underperformance,0.449558625,35400,238842,274242,7450,25138,32588,11935,31710,43645,3341,4988,8329,0.465241588,242776,41033,283809,32830,23566,56396,1,4,293452,529,316573,610025
Not considered,Below average state,KERALA,30-34,0,UP,KERALA,32,B0101,Urban,Underperformance,0.479369985,120840,443494,564334,27627,33416,61043,33355,48015,81370,10196,7386,17582,0.436575858,477607,36348,513955,190394,21432,211826,1,4,641998,539,535243,1177241
Not considered,Below average state,LAKSHADWEEP,30-34,0,UP,LAKSHADWEEP,31,B0101,Urban,Underperformance,0.242741552,184,836,1020,197,615,812,130,474,604,104,296,400,0.518324607,1649,529,2178,747,410,1157,1,4,2067,528,2135,4202
Not considered,Below average state,MADHYA PRADESH,30-34,0,UP,MADHYA PRADESH,23,B0101,Urban,Underperformance,0.529092488,152427,681418,833845,20591,40398,60989,37698,56329,94027,7728,8874,16602,0.400711045,568940,62577,631517,67667,27571,95238,1,3,766793,554,809198,1575991
Not considered,Below average state,MANIPUR,30-34,0,UP,MANIPUR,14,B0101,Urban,Underperformance,0.520135589,11517,24389,35906,3174,2635,5809,5646,3625,9271,1455,685,2140,0.31456426,16879,4836,21715,5916,2955,8871,1,3,35497,551,33535,69032
Not considered,Below average state,NAGALAND,30-34,0,UP,NAGALAND,13,B0101,Urban,Underperformance,0.590649782,8453,20744,29197,984,975,1959,2466,1728,4194,484,242,726,0.30981955,12306,3009,15315,2627,1540,4167,1,3,23709,567,25723,49432
Not considered,Below average state,ODISHA,30-34,0,UP,ODISHA,21,B0101,Urban,Underperformance,0.494219306,44597,243435,288032,6621,14061,20682,14005,21789,35794,2640,3101,5741,0.434512922,226530,26705,253235,30920,15418,46338,1,3,287772,558,295030,582802
Not considered,Below average state,PUDUCHERRY,30-34,0,UP,PUDUCHERRY,34,B0101,Urban,Underperformance,0.54848225,9238,32971,42209,412,721,1133,830,1387,2217,187,270,457,0.416770622,29808,2265,32073,4744,1090,5834,1,4,40063,493,36893,76956
Not considered,Below average state,PUNJAB,30-34,0,UP,PUNJAB,3,B0101,Urban,Underperformance,0.540697722,69696,391537,461233,6257,10686,16943,13425,20071,33496,1955,3181,5136,0.414014464,321692,31476,353168,37950,9771,47721,1,3,406768,556,446265,853033
Not considered,Below average state,UTTAR PRADESH,30-34,0,UP,UTTAR PRADESH,9,B0101,Urban,Underperformance,0.441881345,174513,1214887,1389400,30867,104763,135630,76288,174011,250299,11854,27896,39750,0.465872188,1275288,189546,1464834,114777,70069,184846,1,4,1537943,507,1606340,3144283
Not considered,Below average state,UTTARAKHAND,30-34,0,UP,UTTARAKHAND,5,B0101,Urban,Underperformance,0.514518449,17282,105762,123044,1733,4979,6712,3618,7754,11372,613,1116,1729,0.430698659,94094,8905,102999,10566,4110,14676,1,4,115607,544,123537,239144
Not considered,Below average state,ASSAM,35-39,0,UP,ASSAM,18,B0101,Urban,Underperformance,0.525364964,33257,166761,200018,4995,7022,12017,10326,12085,22411,1610,1881,3491,0.406601142,143880,10922,154802,33521,6180,39701,1,4,189073,516,191649,380722
Not considered,Below average state,CHANDIGARH,35-39,0,UP,CHANDIGARH,4,B0101,Urban,Underperformance,0.64181141,9824,42388,52212,269,395,664,676,682,1358,140,148,288,0.33795528,26600,893,27493,2459,290,2749,1,4,37240,538,44111,81351
Not considered,Below average state,DADRA & NAGAR HAVELI,35-39,0,UP,DADRA & NAGAR HAVELI,26,B0101,Urban,Underperformance,0.676710745,1112,8253,9365,42,36,78,285,214,499,25,23,48,0.283763278,3764,163,3927,182,31,213,1,4,5186,523,8653,13839
Not considered,Below average state,DELHI,35-39,0,UP,DELHI,7,B0101,Urban,Underperformance,0.580434391,105010,642355,747365,3325,9360,12685,8112,17509,25621,1553,2816,4369,0.396274142,491204,19037,510241,25289,7297,32586,1,4,605879,500,681717,1287596
Not considered,Below average state,GOA,35-39,0,UP,GOA,30,B0101,Urban,Underperformance,0.545307526,9613,32873,42486,956,1615,2571,1848,3079,4927,369,615,984,0.378824828,26809,2706,29515,5292,1224,6516,1,4,38639,535,39273,77912
Not considered,Below average state,JAMMU & KASHMIR,35-39,0,UP,JAMMU & KASHMIR,1,B0101,Urban,Underperformance,0.532922117,18978,124442,143420,5351,8379,13730,8802,11745,20547,3085,2058,5143,0.371618609,91258,8752,100010,21226,4161,25387,1,4,122123,524,146997,269120
Not considered,Below average state,JHARKHAND,35-39,0,UP,JHARKHAND,20,B0101,Urban,Underperformance,0.490911789,38014,239846,277860,6814,21083,27897,11444,27512,38956,3263,4308,7571,0.426886192,220562,21059,241621,23630,10256,33886,1,4,273283,529,292725,566008
Not considered,Below average state,KERALA,35-39,0,UP,KERALA,32,B0101,Urban,Underperformance,0.51234207,161073,471692,632765,31753,30403,62156,41952,47008,88960,13771,7121,20892,0.398712111,464770,27657,492427,155336,13765,169101,1,4,681566,539,553478,1235044
Not considered,Below average state,LAKSHADWEEP,35-39,0,UP,LAKSHADWEEP,31,B0101,Urban,Underperformance,0.288790077,221,1013,1234,177,545,722,119,495,614,107,252,359,0.483501053,1660,406,2066,556,285,841,1,4,2107,528,2166,4273
Not considered,Below average state,MADHYA PRADESH,35-39,0,UP,MADHYA PRADESH,23,B0101,Urban,Underperformance,0.559363274,162005,651345,813350,20077,33529,53606,38166,48202,86368,7485,7408,14893,0.370996737,503413,36040,539453,48248,12252,60500,1,3,711069,554,742995,1454064
Not considered,Below average state,MANIPUR,35-39,0,UP,MANIPUR,14,B0101,Urban,Underperformance,0.565894187,11554,24000,35554,2494,2008,4502,4955,3112,8067,1317,581,1898,0.275498186,14622,2687,17309,4168,1337,5505,1,3,32448,551,30380,62828
Not considered,Below average state,NAGALAND,35-39,0,UP,NAGALAND,13,B0101,Urban,Underperformance,0.636053427,7354,18742,26096,711,609,1320,2155,1239,3394,428,208,636,0.265720971,9463,1439,10902,1332,582,1914,1,3,19400,567,21628,41028
Not considered,Below average state,ODISHA,35-39,0,UP,ODISHA,21,B0101,Urban,Underperformance,0.529144355,48007,250323,298330,6057,11095,17152,14220,18632,32852,2772,2678,5450,0.402919845,212705,14460,227165,22788,6741,29529,1,3,277704,558,286093,563797
Not considered,Below average state,PUDUCHERRY,35-39,0,UP,PUDUCHERRY,34,B0101,Urban,Underperformance,0.585575671,10006,33627,43633,401,582,983,904,1139,2043,235,276,511,0.38014843,26903,1423,28326,3252,517,3769,1,4,38048,493,36465,74513
Not considered,Below average state,PUNJAB,35-39,0,UP,PUNJAB,3,B0101,Urban,Underperformance,0.553369311,69680,365395,435075,5376,8806,14182,12526,17113,29639,1957,2783,4740,0.402904243,295453,21322,316775,28766,5048,33814,1,3,379616,556,406613,786229
Not considered,Below average state,UTTAR PRADESH,35-39,0,UP,UTTAR PRADESH,9,B0101,Urban,Underperformance,0.471443396,185539,1244123,1429662,29459,96292,125751,76630,163858,240488,12366,26675,39041,0.436379501,1204963,118367,1323330,94010,36551,130561,1,4,1479498,507,1553023,3032521
Not considered,Below average state,UTTARAKHAND,35-39,0,UP,UTTARAKHAND,5,B0101,Urban,Underperformance,0.540708983,18767,102434,121201,1496,4381,5877,3563,6972,10535,723,991,1714,0.404645062,85507,5195,90702,6894,1896,8790,1,4,108560,544,115592,224152
Not considered,Below average state,ASSAM,40-49,0,UP,ASSAM,18,B0101,Urban,Underperformance,0.578218502,58242,293571,351813,4842,7110,11952,13736,15840,29576,2251,2453,4704,0.36544097,209673,12677,222350,27158,4413,31571,1,4,283902,516,324541,608443
Not considered,Below average state,CHANDIGARH,40-49,0,UP,CHANDIGARH,4,B0101,Urban,Underperformance,0.644450058,15876,65761,81637,287,498,785,868,1027,1895,138,195,333,0.337961903,41219,1593,42812,1892,330,2222,1,4,58101,538,68576,126677
Not considered,Below average state,DADRA & NAGAR HAVELI,40-49,0,UP,DADRA & NAGAR HAVELI,26,B0101,Urban,Underperformance,0.670093332,1244,8664,9908,23,59,82,323,276,599,30,29,59,0.285405113,3961,259,4220,107,52,159,1,4,5558,523,9228,14786
Not considered,Below average state,DELHI,40-49,0,UP,DELHI,7,B0101,Urban,Underperformance,0.593595181,165833,999259,1165092,3711,12267,15978,11052,25457,36509,1879,4016,5895,0.38480068,723084,32192,755276,23374,8996,32370,1,4,901848,500,1060924,1962772
Not considered,Below average state,GOA,40-49,0,UP,GOA,30,B0101,Urban,Underperformance,0.562074195,16938,54591,71529,1151,2050,3201,2795,4761,7556,588,906,1494,0.366810992,41923,4757,46680,4756,1581,6337,1,4,62244,535,65015,127259
Not considered,Below average state,JAMMU & KASHMIR,40-49,0,UP,JAMMU & KASHMIR,1,B0101,Urban,Underperformance,0.553965994,30081,205739,235820,6384,10438,16822,12498,17102,29600,4753,2994,7747,0.358301973,141087,11440,152527,18947,3045,21992,1,4,188419,524,237275,425694
Not considered,Below average state,JHARKHAND,40-49,0,UP,JHARKHAND,20,B0101,Urban,Underperformance,0.525194946,62634,403841,466475,9052,26830,35882,17147,37883,55030,4764,5983,10747,0.400748035,331389,24553,355942,22113,8170,30283,1,4,415934,529,472260,888194
Not considered,Below average state,KERALA,40-49,0,UP,KERALA,32,B0101,Urban,Underperformance,0.523464719,293352,903816,1197168,40517,46186,86703,73720,87778,161498,24588,14665,39253,0.388756401,828980,60109,889089,159283,21901,181184,1,4,1220640,539,1066368,2287008
Not considered,Below average state,LAKSHADWEEP,40-49,0,UP,LAKSHADWEEP,31,B0101,Urban,Underperformance,0.395103858,375,2288,2663,132,556,688,111,550,661,87,286,373,0.45148368,2622,421,3043,558,227,785,1,4,3195,528,3545,6740
Not considered,Below average state,MADHYA PRADESH,40-49,0,UP,MADHYA PRADESH,23,B0101,Urban,Underperformance,0.579306488,262782,1112878,1375660,26502,43717,70219,55809,67721,123530,10743,10395,21138,0.359772128,800785,53554,854339,49949,12413,62362,1,3,1130119,554,1244548,2374667
Not considered,Below average state,MANIPUR,40-49,0,UP,MANIPUR,14,B0101,Urban,Underperformance,0.619088821,20950,41300,62250,2652,2086,4738,7335,4255,11590,1854,775,2629,0.239500353,20701,3381,24082,3436,1003,4439,1,3,50840,551,49711,100551
Not considered,Below average state,NAGALAND,40-49,0,UP,NAGALAND,13,B0101,Urban,Underperformance,0.684760372,10786,30049,40835,574,556,1130,2859,1664,4523,540,200,740,0.226984606,11894,1642,13536,1003,322,1325,1,3,26079,567,33555,59634
Not considered,Below average state,ODISHA,40-49,0,UP,ODISHA,21,B0101,Urban,Underperformance,0.564621608,82814,438666,521480,7573,14237,21810,21213,27917,49130,4316,4140,8456,0.37302835,324084,20442,344526,19350,6122,25472,1,3,432427,558,491165,923592
Not considered,Below average state,PUDUCHERRY,40-49,0,UP,PUDUCHERRY,34,B0101,Urban,Underperformance,0.59627517,15200,55780,70980,441,745,1186,1227,1846,3073,347,443,790,0.37127328,41738,2458,44196,2469,538,3007,1,4,58512,493,60527,119039
Not considered,Below average state,PUNJAB,40-49,0,UP,PUNJAB,3,B0101,Urban,Underperformance,0.550817863,110930,609900,720830,7125,12395,19520,19229,26387,45616,2904,4346,7250,0.408784904,499737,35221,534958,32079,6514,38593,1,3,632800,556,675854,1308654
Not considered,Below average state,UTTAR PRADESH,40-49,0,UP,UTTAR PRADESH,9,B0101,Urban,Underperformance,0.496657669,296938,2046127,2343065,38829,130347,169176,113260,239840,353100,18180,38862,57042,0.416404849,1806865,157594,1964459,103497,36004,139501,1,4,2235243,507,2482423,4717666
Not considered,Below average state,UTTARAKHAND,40-49,0,UP,UTTARAKHAND,5,B0101,Urban,Underperformance,0.557983012,30361,165789,196150,1573,5466,7039,4715,9452,14167,915,1334,2249,0.395318803,130045,8923,138968,5795,1975,7770,1,4,166036,544,185498,351534
Not considered,Below average state,ASSAM,5-Sep,0,UP,ASSAM,18,B0101,Urban,Underperformance,0.006040063,912,1221,2133,651,701,1352,1938,2007,3945,79,79,158,0.982341381,168485,178421,346906,2467,2709,5176,1,4,171414,516,181728,353142
Not considered,Below average state,CHANDIGARH,5-Sep,0,UP,CHANDIGARH,4,B0101,Urban,Underperformance,0.010116344,349,544,893,80,95,175,215,232,447,2,3,5,0.984763178,40024,46904,86928,326,410,736,1,4,40590,538,47683,88273
Not considered,Below average state,DADRA & NAGAR HAVELI,5-Sep,0,UP,DADRA & NAGAR HAVELI,26,B0101,Urban,Underperformance,0.003945033,18,42,60,9,20,29,29,51,80,0,1,1,0.990729174,6897,8171,15068,25,24,49,1,4,6944,523,8265,15209
Not considered,Below average state,DELHI,5-Sep,0,UP,DELHI,7,B0101,Urban,Underperformance,0.004043852,2425,3614,6039,289,395,684,1449,1712,3161,57,81,138,0.993747062,683658,800382,1484040,2413,3111,5524,1,4,687589,500,805789,1493378
Not considered,Below average state,GOA,5-Sep,0,UP,GOA,30,B0101,Urban,Underperformance,0.029142394,917,1024,1941,206,202,408,472,466,938,7,11,18,0.956504114,30701,33006,63707,475,534,1009,1,4,32097,535,34507,66604
Not considered,Below average state,JAMMU & KASHMIR,5-Sep,0,UP,JAMMU & KASHMIR,1,B0101,Urban,Underperformance,0.007480597,901,1365,2266,898,1090,1988,2250,2688,4938,254,286,540,0.974435241,137688,157485,295173,3952,4732,8684,1,4,141093,524,161824,302917
Not considered,Below average state,JHARKHAND,5-Sep,0,UP,JHARKHAND,20,B0101,Urban,Underperformance,0.005253445,1750,2483,4233,603,755,1358,1835,2099,3934,161,198,359,0.989418646,379713,417518,797231,3707,4449,8156,1,4,383459,529,422298,805757
Not considered,Below average state,KERALA,5-Sep,0,UP,KERALA,32,B0101,Urban,Underperformance,0.003113742,1638,2120,3758,906,925,1831,1884,1750,3634,67,91,158,0.993744345,587206,612152,1199358,7881,8301,16182,1,4,590795,539,616113,1206908
Not considered,Below average state,LAKSHADWEEP,5-Sep,0,UP,LAKSHADWEEP,31,B0101,Urban,Underperformance,0.003231419,1,12,13,8,9,17,10,9,19,0,1,1,0.991797166,1980,2010,3990,91,85,176,1,4,1991,528,2032,4023
Not considered,Below average state,MADHYA PRADESH,5-Sep,0,UP,MADHYA PRADESH,23,B0101,Urban,Underperformance,0.007090073,5845,7760,13605,1281,1553,2834,4828,5338,10166,362,510,872,0.987157613,890395,1003842,1894237,7074,8444,15518,1,3,901430,554,1017450,1918880
Not considered,Below average state,MANIPUR,5-Sep,0,UP,MANIPUR,14,B0101,Urban,Underperformance,0.006040384,226,232,458,187,199,386,486,492,978,53,43,96,0.979795049,36404,37887,74291,981,1022,2003,1,3,37169,551,38654,75823
Not considered,Below average state,NAGALAND,5-Sep,0,UP,NAGALAND,13,B0101,Urban,Underperformance,0.004892812,127,164,291,132,163,295,318,313,631,221,252,473,0.976544767,28282,29798,58080,926,1040,1966,1,3,28948,567,30527,59475
Not considered,Below average state,ODISHA,5-Sep,0,UP,ODISHA,21,B0101,Urban,Underperformance,0.006948636,1610,2419,4029,576,694,1270,2284,2549,4833,123,139,262,0.984264245,272986,297716,570702,2424,2832,5256,1,3,277003,558,302823,579826
Not considered,Below average state,PUDUCHERRY,5-Sep,0,UP,PUDUCHERRY,34,B0101,Urban,Underperformance,0.004319457,139,145,284,23,26,49,86,116,202,5,6,11,0.99244095,32002,33250,65252,242,253,495,1,4,32232,493,33517,65749
Not considered,Below average state,PUNJAB,5-Sep,0,UP,PUNJAB,3,B0101,Urban,Underperformance,0.010829306,3733,5591,9324,1630,2140,3770,6498,8219,14717,147,186,333,0.971690958,376842,459781,836623,3697,4688,8385,1,3,387220,556,473777,860997
Not considered,Below average state,UTTAR PRADESH,5-Sep,0,UP,UTTAR PRADESH,9,B0101,Urban,Underperformance,0.013784721,24667,40111,64778,11305,14929,26234,36021,43615,79636,2037,2608,4645,0.968280332,2130808,2419394,4550202,22413,28308,50721,1,4,2193533,507,2505728,4699261
Not considered,Below average state,UTTARAKHAND,5-Sep,0,UP,UTTARAKHAND,5,B0101,Urban,Underperformance,0.006325051,729,1094,1823,322,442,764,1152,1484,2636,45,61,106,0.98416135,130369,153285,283654,862,1103,1965,1,4,132295,544,155924,288219
Not considered,Below average state,ASSAM,50-59,0,UP,ASSAM,18,B0101,Urban,Underperformance,0.587266716,31380,186752,218132,1539,2580,4119,6588,8015,14603,1138,1277,2415,0.366916508,123363,12923,136286,6853,1782,8635,1,4,162469,516,208967,371436
Not considered,Below average state,CHANDIGARH,50-59,0,UP,CHANDIGARH,4,B0101,Urban,Underperformance,0.618171898,9134,40716,49850,84,179,263,369,527,896,47,105,152,0.368832232,25925,3818,29743,487,267,754,1,4,35475,538,45166,80641
Not considered,Below average state,DADRA & NAGAR HAVELI,50-59,0,UP,DADRA & NAGAR HAVELI,26,B0101,Urban,Underperformance,0.576515733,521,3235,3756,16,16,32,141,122,263,16,13,29,0.37866462,2146,321,2467,43,16,59,1,4,2824,523,3691,6515
Not considered,Below average state,DELHI,50-59,0,UP,DELHI,7,B0101,Urban,Underperformance,0.559118045,93629,561498,655127,1285,5002,6287,5019,12417,17436,825,2116,2941,0.423491207,440124,56087,496211,6623,6522,13145,1,4,539597,500,632118,1171715
Not considered,Below average state,GOA,50-59,0,UP,GOA,30,B0101,Urban,Underperformance,0.505481549,10268,34318,44586,438,856,1294,1732,2836,4568,373,556,929,0.432197721,31320,6802,38122,1279,926,2205,1,4,43693,535,44512,88205
Not considered,Below average state,JAMMU & KASHMIR,50-59,0,UP,JAMMU & KASHMIR,1,B0101,Urban,Underperformance,0.488322929,15588,111918,127506,2557,4922,7479,6428,9488,15916,2487,1866,4353,0.434050783,96700,16635,113335,6315,2115,8430,1,4,121203,524,139907,261110
Not considered,Below average state,JHARKHAND,50-59,0,UP,JHARKHAND,20,B0101,Urban,Underperformance,0.514115271,37020,265907,302927,3892,11138,15030,8904,18853,27757,2710,3353,6063,0.428486813,224036,28437,252473,7516,3941,11457,1,4,272670,529,316550,589220
Not considered,Below average state,KERALA,50-59,0,UP,KERALA,32,B0101,Urban,Underperformance,0.448443042,158535,633419,791954,14712,23709,38421,42506,68315,110821,15239,13706,28945,0.472414621,688787,145501,834288,46865,20239,67104,1,4,905067,539,860941,1766008
Not considered,Below average state,LAKSHADWEEP,50-59,0,UP,LAKSHADWEEP,31,B0101,Urban,Underperformance,0.445456471,284,1819,2103,39,141,180,49,226,275,41,90,131,0.4685448,1875,337,2212,151,116,267,1,4,2249,528,2472,4721
Not considered,Below average state,MADHYA PRADESH,50-59,0,UP,MADHYA PRADESH,23,B0101,Urban,Underperformance,0.559051159,140378,680204,820582,12423,19537,31960,29359,35012,64371,5970,5501,11471,0.389278736,507412,63976,571388,18150,7460,25610,1,3,683119,554,784693,1467812
Not considered,Below average state,MANIPUR,50-59,0,UP,MANIPUR,14,B0101,Urban,Underperformance,0.621985918,15096,28188,43284,1251,782,2033,4527,2453,6980,1206,487,1693,0.253384107,14414,3219,17633,1280,418,1698,1,3,35243,551,34347,69590
Not considered,Below average state,NAGALAND,50-59,0,UP,NAGALAND,13,B0101,Urban,Underperformance,0.641723356,4687,14557,19244,189,227,416,1226,782,2008,228,129,357,0.279411765,6246,2133,8379,301,169,470,1,3,12387,567,17601,29988
Not considered,Below average state,ODISHA,50-59,0,UP,ODISHA,21,B0101,Urban,Underperformance,0.536289321,42734,268228,310962,3026,5694,8720,11286,15389,26675,2357,2433,4790,0.409445709,205588,31825,237413,5941,3351,9292,1,3,261965,558,317875,579840
Not considered,Below average state,PUDUCHERRY,50-59,0,UP,PUDUCHERRY,34,B0101,Urban,Underperformance,0.525862616,8119,33350,41469,149,278,427,631,1102,1733,213,299,512,0.445668852,30319,4826,35145,659,321,980,1,4,39282,493,39577,78859
Not considered,Below average state,PUNJAB,50-59,0,UP,PUNJAB,3,B0101,Urban,Underperformance,0.521239529,64924,400030,464954,2961,6374,9335,10646,15785,26431,1441,2508,3949,0.444702786,347155,49527,396682,12612,4909,17521,1,3,424166,556,467850,892016
Not considered,Below average state,UTTAR PRADESH,50-59,0,UP,UTTAR PRADESH,9,B0101,Urban,Underperformance,0.494055274,184143,1284129,1468272,19301,61891,81192,65445,131789,197234,10808,21273,32081,0.428783079,1136329,137962,1274291,43726,19169,62895,1,4,1396725,507,1575153,2971878
Not considered,Below average state,UTTARAKHAND,50-59,0,UP,UTTARAKHAND,5,B0101,Urban,Underperformance,0.536673819,17108,103203,120311,668,2183,2851,2551,4792,7343,465,697,1162,0.425387748,84165,11198,95363,1746,1217,2963,1,4,104289,544,119890,224179
Not considered,Below average state,ASSAM,60-69,0,UP,ASSAM,18,B0101,Urban,Underperformance,0.324590101,8609,58859,67468,554,1166,1720,2974,4496,7470,508,822,1330,0.633072897,86406,45182,131588,2864,2018,4882,1,4,98497,516,109359,207856
Not considered,Below average state,CHANDIGARH,60-69,0,UP,CHANDIGARH,4,B0101,Urban,Underperformance,0.237311754,1365,8342,9707,38,107,145,153,317,470,31,64,95,0.748875416,17992,12640,30632,171,287,458,1,4,19541,538,21363,40904
Not considered,Below average state,DADRA & NAGAR HAVELI,60-69,0,UP,DADRA & NAGAR HAVELI,26,B0101,Urban,Underperformance,0.334005764,127,1032,1159,3,7,10,68,62,130,6,9,15,0.624207493,1477,689,2166,31,21,52,1,4,1678,523,1792,3470
Not considered,Below average state,DELHI,60-69,0,UP,DELHI,7,B0101,Urban,Underperformance,0.267653194,23148,171362,194510,666,2510,3176,2544,6768,9312,546,1657,2203,0.716501726,331810,188889,520699,2728,5186,7914,1,4,358048,500,368676,726724
Not considered,Below average state,GOA,60-69,0,UP,GOA,30,B0101,Urban,Underperformance,0.215238689,2889,10227,13116,190,291,481,729,1258,1987,253,355,608,0.742176346,27868,17358,45226,521,488,1009,1,4,31739,535,29198,60937
Not considered,Below average state,JAMMU & KASHMIR,60-69,0,UP,JAMMU & KASHMIR,1,B0101,Urban,Underperformance,0.244945801,3214,35969,39183,949,2660,3609,2876,5889,8765,1022,1529,2551,0.684314167,68704,40763,109467,2873,2380,5253,1,4,75816,524,84150,159966
Not considered,Below average state,JHARKHAND,60-69,0,UP,JHARKHAND,20,B0101,Urban,Underperformance,0.248111879,10657,76400,87057,1656,5170,6826,4268,10928,15196,1426,2416,3842,0.697629945,148204,96579,244783,3325,4116,7441,1,4,164555,529,186323,350878
Not considered,Below average state,KERALA,60-69,0,UP,KERALA,32,B0101,Urban,Underperformance,0.222569482,44519,215129,259648,4230,7316,11546,18202,34572,52774,6946,9366,16312,0.718210207,544472,293387,837859,14227,12083,26310,1,4,614139,539,552454,1166593
Not considered,Below average state,LAKSHADWEEP,60-69,0,UP,LAKSHADWEEP,31,B0101,Urban,Underperformance,0.075841657,17,188,205,8,50,58,14,99,113,4,55,59,0.860525342,1271,1055,2326,41,119,160,1,4,1306,528,1397,2703
Not considered,Below average state,MADHYA PRADESH,60-69,0,UP,MADHYA PRADESH,23,B0101,Urban,Underperformance,0.316868491,58903,233540,292443,6687,9975,16662,16980,21065,38045,4322,4225,8547,0.632648042,382808,201073,583881,9269,8105,17374,1,3,463013,554,459903,922916
Not considered,Below average state,MANIPUR,60-69,0,UP,MANIPUR,14,B0101,Urban,Underperformance,0.408535965,5427,10635,16062,501,349,850,2090,1498,3588,712,360,1072,0.472937227,11854,6740,18594,603,379,982,1,3,20083,551,19233,39316
Not considered,Below average state,NAGALAND,60-69,0,UP,NAGALAND,13,B0101,Urban,Underperformance,0.396123917,1396,4000,5396,67,87,154,559,487,1046,108,72,180,0.513874615,3903,3097,7000,148,152,300,1,3,5966,567,7656,13622
Not considered,Below average state,ODISHA,60-69,0,UP,ODISHA,21,B0101,Urban,Underperformance,0.25923386,12774,73414,86188,1187,2590,3777,5281,9056,14337,1360,1863,3223,0.687949662,139544,89180,228724,2701,3202,5903,1,3,158959,558,173513,332472
Not considered,Below average state,PUDUCHERRY,60-69,0,UP,PUDUCHERRY,34,B0101,Urban,Underperformance,0.215537793,2187,8572,10759,54,97,151,291,579,870,116,158,274,0.761544163,24447,13567,38014,229,249,478,1,4,27041,493,22876,49917
Not considered,Below average state,PUNJAB,60-69,0,UP,PUNJAB,3,B0101,Urban,Underperformance,0.312574071,20138,156572,176710,1720,3556,5276,6123,9942,16065,811,1760,2571,0.654461579,250626,119366,369992,6723,4978,11701,1,3,277698,556,287640,565338
Not considered,Below average state,UTTAR PRADESH,60-69,0,UP,UTTAR PRADESH,9,B0101,Urban,Underperformance,0.344867543,84035,561805,645840,10901,33942,44843,37685,80597,118282,7043,15265,22308,0.580059795,763318,322971,1086289,25484,21853,47337,1,4,892081,507,980638,1872719
Not considered,Below average state,UTTARAKHAND,60-69,0,UP,UTTARAKHAND,5,B0101,Urban,Underperformance,0.274295679,4906,33474,38380,329,1182,1511,1440,3025,4465,292,602,894,0.687404411,59755,36428,96183,915,1210,2125,1,4,66393,544,73529,139922
Not considered,Below average state,ASSAM,60+,0,UP,ASSAM,18,B0101,Urban,Underperformance,0.277212708,11717,80049,91766,798,1567,2365,4233,6510,10743,692,1210,1902,0.684588452,143861,82759,226620,3878,2631,6509,1,4,160503,516,170528,331031
Not considered,Below average state,CHANDIGARH,60+,0,UP,CHANDIGARH,4,B0101,Urban,Underperformance,0.191133677,1779,10832,12611,48,126,174,224,446,670,36,87,123,0.79684753,29719,22857,52576,228,352,580,1,4,31758,538,34222,65980
Not considered,Below average state,DADRA & NAGAR HAVELI,60+,0,UP,DADRA & NAGAR HAVELI,26,B0101,Urban,Underperformance,0.280738485,160,1315,1475,3,9,12,91,85,176,8,12,20,0.681956604,2386,1197,3583,34,25,59,1,4,2645,523,2609,5254
Not considered,Below average state,DELHI,60+,0,UP,DELHI,7,B0101,Urban,Underperformance,0.21679248,28866,214009,242875,826,2976,3802,3444,8745,12189,728,2144,2872,0.769763932,523976,338399,862375,3570,6561,10131,1,4,557014,500,563297,1120311
Not considered,Below average state,GOA,60+,0,UP,GOA,30,B0101,Urban,Underperformance,0.18027183,4096,13518,17614,244,370,614,1014,1678,2692,324,473,797,0.784019732,47045,29560,76605,695,621,1316,1,4,52479,535,45229,97708
Not considered,Below average state,JAMMU & KASHMIR,60+,0,UP,JAMMU & KASHMIR,1,B0101,Urban,Underperformance,0.209485494,4625,52080,56705,1429,3739,5168,4297,8751,13048,1399,2328,3727,0.72854256,120275,76932,197207,4192,3496,7688,1,4,130596,524,140091,270687
Not considered,Below average state,JHARKHAND,60+,0,UP,JHARKHAND,20,B0101,Urban,Underperformance,0.214538665,13464,98915,112379,2043,6483,8526,5439,14433,19872,1784,3375,5159,0.737675562,226261,160146,386407,4501,5511,10012,1,4,246948,529,276869,523817
Not considered,Below average state,KERALA,60+,0,UP,KERALA,32,B0101,Urban,Underperformance,0.163631772,55952,270631,326583,5067,8787,13854,23180,45563,68743,8780,12905,21685,0.791060009,1014654,564176,1578830,18066,14561,32627,1,4,1102566,539,893275,1995841
Not considered,Below average state,LAKSHADWEEP,60+,0,UP,LAKSHADWEEP,31,B0101,Urban,Underperformance,0.061615919,23,234,257,13,62,75,18,119,137,6,70,76,0.88731719,2035,1666,3701,53,149,202,1,4,2082,528,2089,4171
Not considered,Below average state,MADHYA PRADESH,60+,0,UP,MADHYA PRADESH,23,B0101,Urban,Underperformance,0.262886265,78442,320806,399248,8710,13502,22212,22839,30465,53304,6006,6476,12482,0.693796709,670225,383451,1053676,13193,11478,24671,1,3,777512,554,741198,1518710
Not considered,Below average state,MANIPUR,60+,0,UP,MANIPUR,14,B0101,Urban,Underperformance,0.326189606,7474,14839,22313,678,524,1202,2928,2350,5278,978,596,1574,0.573642278,24252,14988,39240,848,543,1391,1,3,35632,551,32773,68405
Not considered,Below average state,NAGALAND,60+,0,UP,NAGALAND,13,B0101,Urban,Underperformance,0.345273075,1979,5424,7403,94,111,205,759,676,1435,155,121,276,0.574926543,6881,5446,12327,223,215,438,1,3,9774,567,11667,21441
Not considered,Below average state,ODISHA,60+,0,UP,ODISHA,21,B0101,Urban,Underperformance,0.213333456,17193,99030,116223,1571,3349,4920,7213,12905,20118,1826,2750,4576,0.741339403,238509,165369,403878,3766,4212,7978,1,3,264741,558,280054,544795
Not considered,Below average state,PUDUCHERRY,60+,0,UP,PUDUCHERRY,34,B0101,Urban,Underperformance,0.165464114,2930,10967,13897,59,118,177,385,789,1174,149,224,373,0.816116588,43337,25207,68544,309,319,628,1,4,46801,493,37187,83988
Not considered,Below average state,PUNJAB,60+,0,UP,PUNJAB,3,B0101,Urban,Underperformance,0.266778034,27566,214697,242263,2395,5001,7396,9097,14779,23876,1139,2688,3827,0.702715649,410600,227541,638141,8768,6757,15525,1,3,448402,556,459705,908107
Not considered,Below average state,UTTAR PRADESH,60+,0,UP,UTTAR PRADESH,9,B0101,Urban,Underperformance,0.306618882,119083,798761,917844,15778,47231,63009,55740,119248,174988,10215,23167,33382,0.623772147,1248900,618322,1867222,34393,31130,65523,1,4,1433938,507,1559498,2993436
Not considered,Below average state,UTTARAKHAND,60+,0,UP,UTTARAKHAND,5,B0101,Urban,Underperformance,0.237745501,6715,46729,53444,457,1604,2061,2094,4425,6519,391,888,1279,0.727565115,99299,64254,163553,1300,1669,2969,1,4,108499,544,116296,224795
Not considered,Below average state,ASSAM,70-79,0,UP,ASSAM,18,B0101,Urban,Underperformance,0.214177352,2307,16752,19059,158,274,432,916,1535,2451,124,289,413,0.753638172,40301,26763,67064,651,433,1084,1,4,43648,516,45339,88987
Not considered,Below average state,CHANDIGARH,70-79,0,UP,CHANDIGARH,4,B0101,Urban,Underperformance,0.125121076,272,1924,2196,8,13,21,56,92,148,4,18,22,0.865192867,8105,7080,15185,37,51,88,1,4,8437,538,9114,17551
Not considered,Below average state,DADRA & NAGAR HAVELI,70-79,0,UP,DADRA & NAGAR HAVELI,26,B0101,Urban,Underperformance,0.177432543,23,194,217,0,2,2,16,18,34,2,3,5,0.790678659,610,357,967,2,2,4,1,4,651,523,572,1223
Not considered,Below average state,DELHI,70-79,0,UP,DELHI,7,B0101,Urban,Underperformance,0.129001545,4012,32570,36582,107,344,451,643,1462,2105,141,379,520,0.861741743,136540,107831,244371,539,962,1501,1,4,141336,500,142242,283578
Not considered,Below average state,GOA,70-79,0,UP,GOA,30,B0101,Urban,Underperformance,0.127772491,884,2607,3491,39,55,94,211,330,541,64,100,164,0.846424127,13811,9315,23126,109,98,207,1,4,14970,535,12352,27322
Not considered,Below average state,JAMMU & KASHMIR,70-79,0,UP,JAMMU & KASHMIR,1,B0101,Urban,Underperformance,0.165149245,932,11965,12897,290,790,1080,978,2152,3130,286,600,886,0.783424891,36088,25092,61180,842,773,1615,1,4,38284,524,39809,78093
Not considered,Below average state,JHARKHAND,70-79,0,UP,JHARKHAND,20,B0101,Urban,Underperformance,0.155058648,2124,17639,19763,280,991,1271,877,2771,3648,288,769,1057,0.808026362,56005,46982,102987,800,967,1767,1,4,59294,529,68161,127455
Not considered,Below average state,KERALA,70-79,0,UP,KERALA,32,B0101,Urban,Underperformance,0.096490959,9322,47230,56552,646,1263,1909,4073,9293,13366,1546,2996,4542,0.872953799,318691,192935,511626,2871,2095,4966,1,4,333632,539,252454,586086
Not considered,Below average state,LAKSHADWEEP,70-79,0,UP,LAKSHADWEEP,31,B0101,Urban,Underperformance,0.031569174,2,32,34,4,5,9,3,13,16,2,11,13,0.941504178,544,470,1014,9,25,34,1,4,551,528,526,1077
Not considered,Below average state,MADHYA PRADESH,70-79,0,UP,MADHYA PRADESH,23,B0101,Urban,Underperformance,0.193782193,14659,66565,81224,1534,2620,4154,4453,7105,11558,1351,1691,3042,0.771385491,195317,128010,323327,2627,2319,4946,1,3,215780,554,203371,419151
Not considered,Below average state,MANIPUR,70-79,0,UP,MANIPUR,14,B0101,Urban,Underperformance,0.250141483,1615,3247,4862,133,120,253,647,615,1262,215,176,391,0.664814529,7783,5139,12922,159,106,265,1,3,10260,551,9177,19437
Not considered,Below average state,NAGALAND,70-79,0,UP,NAGALAND,13,B0101,Urban,Underperformance,0.278979907,406,1038,1444,20,18,38,146,138,284,35,30,65,0.653593509,1850,1533,3383,46,41,87,1,3,2437,567,2739,5176
Not considered,Below average state,ODISHA,70-79,0,UP,ODISHA,21,B0101,Urban,Underperformance,0.151976043,3326,19816,23142,247,574,821,1404,3044,4448,384,709,1093,0.811635604,70048,53543,123591,719,719,1438,1,3,75162,558,77112,152274
Not considered,Below average state,PUDUCHERRY,70-79,0,UP,PUDUCHERRY,34,B0101,Urban,Underperformance,0.103751062,595,1969,2564,4,15,19,78,177,255,27,56,83,0.882571926,13367,8444,21811,57,55,112,1,4,14067,493,10646,24713
Not considered,Below average state,PUNJAB,70-79,0,UP,PUNJAB,3,B0101,Urban,Underperformance,0.211733719,5352,45051,50403,453,1059,1512,2061,3513,5574,241,705,946,0.760876962,108557,72569,181126,1508,1339,2847,1,3,116211,556,121838,238049
Not considered,Below average state,UTTAR PRADESH,70-79,0,UP,UTTAR PRADESH,9,B0101,Urban,Underperformance,0.25517669,23663,169333,192996,2993,8730,11723,11740,26405,38145,2249,5608,7857,0.68400009,321333,195992,517325,5857,5829,11686,1,4,358985,507,397338,756323
Not considered,Below average state,UTTARAKHAND,70-79,0,UP,UTTARAKHAND,5,B0101,Urban,Underperformance,0.18826018,1297,9739,11036,81,303,384,425,1012,1437,73,211,284,0.78238174,26321,19543,45864,203,296,499,1,4,28116,544,30505,58621
Not considered,Below average state,ASSAM,80+,0,UP,ASSAM,18,B0101,Urban,Underperformance,0.153240903,801,4438,5239,86,127,213,343,479,822,60,99,159,0.818064818,17154,10814,27968,363,180,543,1,4,18358,516,15830,34188
Not considered,Below average state,CHANDIGARH,80+,0,UP,CHANDIGARH,4,B0101,Urban,Underperformance,0.094086379,142,566,708,2,6,8,15,37,52,1,5,6,0.89820598,3622,3137,6759,20,14,34,1,4,3780,538,3745,7525
Not considered,Below average state,DADRA & NAGAR HAVELI,80+,0,UP,DADRA & NAGAR HAVELI,26,B0101,Urban,Underperformance,0.176470588,10,89,99,0,0,0,7,5,12,0,0,0,0.802139037,299,151,450,1,2,3,1,4,316,523,245,561
Not considered,Below average state,DELHI,80+,0,UP,DELHI,7,B0101,Urban,Underperformance,0.107109418,1706,10077,11783,53,122,175,257,515,772,41,108,149,0.884518539,55626,41679,97305,303,413,716,1,4,57630,500,52379,110009
Not considered,Below average state,GOA,80+,0,UP,GOA,30,B0101,Urban,Underperformance,0.106572124,323,684,1007,15,24,39,74,90,164,7,18,25,0.873425759,5366,2887,8253,65,35,100,1,4,5770,535,3679,9449
Not considered,Below average state,JAMMU & KASHMIR,80+,0,UP,JAMMU & KASHMIR,1,B0101,Urban,Underperformance,0.141749418,479,4146,4625,190,289,479,443,710,1153,91,199,290,0.814024764,15483,11077,26560,477,343,820,1,4,16496,524,16132,32628
Not considered,Below average state,JHARKHAND,80+,0,UP,JHARKHAND,20,B0101,Urban,Underperformance,0.122218802,683,4876,5559,107,322,429,294,734,1028,70,190,260,0.849463548,22052,16585,38637,376,428,804,1,4,23099,529,22385,45484
Not considered,Below average state,KERALA,80+,0,UP,KERALA,32,B0101,Urban,Underperformance,0.042699928,2111,8272,10383,191,208,399,905,1698,2603,288,543,831,0.943177799,151491,77854,229345,968,383,1351,1,4,154795,539,88367,243162
Not considered,Below average state,LAKSHADWEEP,80+,0,UP,LAKSHADWEEP,31,B0101,Urban,Underperformance,0.046035806,4,14,18,1,7,8,1,7,8,0,4,4,0.923273657,220,141,361,3,5,8,1,4,225,528,166,391
Not considered,Below average state,MADHYA PRADESH,80+,0,UP,MADHYA PRADESH,23,B0101,Urban,Underperformance,0.144817513,4880,20701,25581,489,907,1396,1406,2295,3701,333,560,893,0.829175229,92100,54368,146468,1297,1054,2351,1,3,98719,554,77924,176643
Not considered,Below average state,MANIPUR,80+,0,UP,MANIPUR,14,B0101,Urban,Underperformance,0.143907998,432,957,1389,44,55,99,191,237,428,51,60,111,0.800248653,4615,3109,7724,86,58,144,1,3,5289,551,4363,9652
Not considered,Below average state,NAGALAND,80+,0,UP,NAGALAND,13,B0101,Urban,Underperformance,0.213015513,177,386,563,7,6,13,54,51,105,12,19,31,0.735527809,1128,816,1944,29,22,51,1,3,1371,567,1272,2643
Not considered,Below average state,ODISHA,80+,0,UP,ODISHA,21,B0101,Urban,Underperformance,0.114789589,1093,5800,6893,137,185,322,528,805,1333,82,178,260,0.858682076,28917,22646,51563,346,291,637,1,3,30620,558,29429,60049
Not considered,Below average state,PUDUCHERRY,80+,0,UP,PUDUCHERRY,34,B0101,Urban,Underperformance,0.061337893,148,426,574,1,6,7,16,33,49,6,10,16,0.931716179,5523,3196,8719,23,15,38,1,4,5693,493,3665,9358
Not considered,Below average state,PUNJAB,80+,0,UP,PUNJAB,3,B0101,Urban,Underperformance,0.144671505,2076,13074,15150,222,386,608,913,1324,2237,87,223,310,0.831006494,51417,35606,87023,537,440,977,1,3,54493,556,50227,104720
Not considered,Below average state,UTTAR PRADESH,80+,0,UP,UTTAR PRADESH,9,B0101,Urban,Underperformance,0.216820255,11385,67623,79008,1884,4559,6443,6315,12246,18561,923,2294,3217,0.723414765,164249,99359,263608,3052,3448,6500,1,4,182872,507,181522,364394
Not considered,Below average state,UTTARAKHAND,80+,0,UP,UTTARAKHAND,5,B0101,Urban,Underperformance,0.153435929,512,3516,4028,47,119,166,229,388,617,26,75,101,0.819213774,13223,8283,21506,182,163,345,1,4,13990,544,12262,26252
Not considered,Below average state,ASSAM,Age not stated,0,UP,ASSAM,18,B0101,Urban,Underperformance,0.281997372,214,859,1073,49,60,109,135,154,289,8,8,16,0.637844941,1406,1021,2427,102,74,176,1,4,1763,516,2042,3805
Not considered,Below average state,CHANDIGARH,Age not stated,0,UP,CHANDIGARH,4,B0101,Urban,Underperformance,0.338235294,30,85,115,2,2,4,5,4,9,0,2,2,0.629411765,108,106,214,4,7,11,1,4,143,538,197,340
Not considered,Below average state,DADRA & NAGAR HAVELI,Age not stated,0,UP,DADRA & NAGAR HAVELI,26,B0101,Urban,Underperformance,0.375,9,48,57,0,0,0,3,5,8,0,0,0,0.572368421,53,34,87,0,1,1,1,4,65,523,87,152
Not considered,Below average state,DELHI,Age not stated,0,UP,DELHI,7,B0101,Urban,Underperformance,0.257645968,639,3531,4170,29,77,106,110,215,325,15,31,46,0.719431572,6527,5117,11644,214,227,441,1,4,7291,500,8894,16185
Not considered,Below average state,GOA,Age not stated,0,UP,GOA,30,B0101,Urban,Underperformance,0.322278912,104,275,379,16,19,35,31,53,84,3,7,10,0.597789116,424,279,703,22,23,45,1,4,562,535,614,1176
Not considered,Below average state,JAMMU & KASHMIR,Age not stated,0,UP,JAMMU & KASHMIR,1,B0101,Urban,Underperformance,0.299111319,116,1163,1279,47,71,118,86,128,214,9,43,52,0.63868101,1177,1554,2731,124,63,187,1,4,1388,524,2888,4276
Not considered,Below average state,JHARKHAND,Age not stated,0,UP,JHARKHAND,20,B0101,Urban,Underperformance,0.2240087,1980,11409,13389,436,1371,1807,926,2247,3173,147,272,419,0.715894261,24590,18199,42789,1463,1782,3245,1,4,27643,529,32127,59770
Not considered,Below average state,KERALA,Age not stated,0,UP,KERALA,32,B0101,Urban,Underperformance,0.217272144,1034,2692,3726,153,153,306,273,415,688,65,60,125,0.735319844,7159,5451,12610,787,320,1107,1,4,8531,539,8618,17149
Not considered,Below average state,LAKSHADWEEP,Age not stated,0,UP,LAKSHADWEEP,31,B0101,Urban,Underperformance,0.079545455,1,6,7,1,1,2,0,3,3,1,0,1,0.875,32,45,77,3,8,11,1,4,34,528,54,88
Not considered,Below average state,MADHYA PRADESH,Age not stated,0,UP,MADHYA PRADESH,23,B0101,Urban,Underperformance,0.252418992,1789,7185,8974,228,411,639,685,1042,1727,72,98,170,0.694222547,14505,10176,24681,551,478,1029,1,3,17051,554,18501,35552
Not considered,Below average state,MANIPUR,Age not stated,0,UP,MANIPUR,14,B0101,Urban,Underperformance,0.250823529,189,344,533,49,31,80,108,86,194,23,5,28,0.644705882,716,654,1370,76,62,138,1,3,1036,551,1089,2125
Not considered,Below average state,NAGALAND,Age not stated,0,UP,NAGALAND,13,B0101,Urban,Underperformance,0.228426396,10,35,45,2,0,2,7,11,18,2,3,5,0.654822335,61,68,129,5,1,6,1,3,80,567,117,197
Not considered,Below average state,ODISHA,Age not stated,0,UP,ODISHA,21,B0101,Urban,Underperformance,0.261675222,1057,5213,6270,214,370,584,530,845,1375,52,83,135,0.675305705,9445,6736,16181,554,657,1211,1,3,11084,558,12877,23961
Not considered,Below average state,PUDUCHERRY,Age not stated,0,UP,PUDUCHERRY,34,B0101,Urban,Underperformance,0.243781095,33,114,147,3,0,3,6,5,11,2,5,7,0.726368159,260,178,438,10,11,21,1,4,301,493,302,603
Not considered,Below average state,PUNJAB,Age not stated,0,UP,PUNJAB,3,B0101,Urban,Underperformance,0.257051713,538,2524,3062,65,106,171,188,316,504,22,29,51,0.696356615,4725,3570,8295,226,152,378,1,3,5473,556,6439,11912
Not considered,Below average state,UTTAR PRADESH,Age not stated,0,UP,UTTAR PRADESH,9,B0101,Urban,Underperformance,0.234622981,15870,89624,105494,3447,8362,11809,10305,19819,30124,854,2234,3088,0.69151217,181050,129876,310926,5577,6753,12330,1,4,208079,507,241553,449632
Not considered,Below average state,UTTARAKHAND,Age not stated,0,UP,UTTARAKHAND,5,B0101,Urban,Underperformance,0.280964798,240,1484,1724,36,109,145,104,263,367,5,20,25,0.655149935,2223,1797,4020,100,119,219,1,4,2572,544,3564,6136
Not considered,Below average state,ASSAM,Oct-14,0,UP,ASSAM,18,B0101,Urban,Underperformance,0.020104041,2410,5470,7880,1492,1990,3482,3440,4043,7483,381,573,954,0.958370858,184113,191531,375644,6988,8151,15139,1,4,190344,516,201617,391961
Not considered,Below average state,CHANDIGARH,Oct-14,0,UP,CHANDIGARH,4,B0101,Urban,Underperformance,0.023326405,740,1381,2121,110,161,271,271,355,626,28,47,75,0.968964114,39169,48936,88105,567,859,1426,1,4,40208,538,50719,90927
Not considered,Below average state,DADRA & NAGAR HAVELI,Oct-14,0,UP,DADRA & NAGAR HAVELI,26,B0101,Urban,Underperformance,0.026875346,89,251,340,15,21,36,43,53,96,1,3,4,0.965220141,5697,6514,12211,34,45,79,1,4,5830,523,6821,12651
Not considered,Below average state,DELHI,Oct-14,0,UP,DELHI,7,B0101,Urban,Underperformance,0.012360635,4850,14955,19805,608,1259,1867,2230,3287,5517,242,557,799,0.983697443,724975,851168,1576143,5691,10316,16007,1,4,732297,500,869967,1602264
Not considered,Below average state,GOA,Oct-14,0,UP,GOA,30,B0101,Urban,Underperformance,0.035413932,1039,1416,2455,246,311,557,575,654,1229,21,38,59,0.946006376,31575,34005,65580,916,1009,1925,1,4,33210,535,36113,69323
Not considered,Below average state,JAMMU & KASHMIR,Oct-14,0,UP,JAMMU & KASHMIR,1,B0101,Urban,Underperformance,0.015621397,1596,3350,4946,1967,2429,4396,3710,4244,7954,897,1027,1924,0.953180025,141070,160723,301793,9181,10942,20123,1,4,147273,524,169344,316617
Not considered,Below average state,JHARKHAND,Oct-14,0,UP,JHARKHAND,20,B0101,Urban,Underperformance,0.013258703,3399,8099,11498,1444,2513,3957,3326,4611,7937,759,1043,1802,0.975510952,409139,436828,845967,8725,12015,20740,1,4,416623,529,450581,867204
Not considered,Below average state,KERALA,Oct-14,0,UP,KERALA,32,B0101,Urban,Underperformance,0.004999123,2283,4333,6616,1784,1965,3749,2940,3234,6174,159,262,421,0.990017621,642030,668191,1310221,18285,19086,37371,1,4,647412,539,676020,1323432
Not considered,Below average state,LAKSHADWEEP,Oct-14,0,UP,LAKSHADWEEP,31,B0101,Urban,Underperformance,0.002603602,6,6,12,7,14,21,8,12,20,1,2,3,0.992406162,2352,2222,4574,205,191,396,1,4,2367,528,2242,4609
Not considered,Below average state,MADHYA PRADESH,Oct-14,0,UP,MADHYA PRADESH,23,B0101,Urban,Underperformance,0.020247991,12274,29912,42186,3330,5859,9189,8660,12041,20701,1893,2693,4586,0.967615022,959411,1056582,2015993,16419,23594,40013,1,3,982238,554,1101228,2083466
Not considered,Below average state,MANIPUR,Oct-14,0,UP,MANIPUR,14,B0101,Urban,Underperformance,0.013060624,449,634,1083,533,397,930,933,793,1726,303,250,553,0.959455385,39304,40255,79559,2126,2151,4277,1,3,40989,551,41932,82921
Not considered,Below average state,NAGALAND,Oct-14,0,UP,NAGALAND,13,B0101,Urban,Underperformance,0.016439087,395,715,1110,308,339,647,794,857,1651,707,767,1474,0.937279701,31047,32240,63287,1679,1897,3576,1,3,32943,567,34579,67522
Not considered,Below average state,ODISHA,Oct-14,0,UP,ODISHA,21,B0101,Urban,Underperformance,0.018142839,3745,7925,11670,1597,2202,3799,4180,4941,9121,646,813,1459,0.965408898,303666,317313,620979,7319,9695,17014,1,3,312237,558,330992,643229
Not considered,Below average state,PUDUCHERRY,Oct-14,0,UP,PUDUCHERRY,34,B0101,Urban,Underperformance,0.008568384,196,407,603,30,43,73,121,142,263,10,13,23,0.987367673,34084,35402,69486,408,499,907,1,4,34411,493,35964,70375
Not considered,Below average state,PUNJAB,Oct-14,0,UP,PUNJAB,3,B0101,Urban,Underperformance,0.026323731,6326,17749,24075,2722,4358,7080,8841,12220,21061,371,877,1248,0.949283492,384872,483318,868190,7162,11272,18434,1,3,400410,556,514164,914574
Not considered,Below average state,UTTAR PRADESH,Oct-14,0,UP,UTTAR PRADESH,9,B0101,Urban,Underperformance,0.028166142,42127,101406,143533,19376,32299,51675,53683,73077,126760,5847,9340,15187,0.943978943,2277452,2533009,4810461,43529,69236,112765,1,4,2379109,507,2716832,5095941
Not considered,Below average state,UTTARAKHAND,Oct-14,0,UP,UTTARAKHAND,5,B0101,Urban,Underperformance,0.016371703,1194,3880,5074,521,1053,1574,1589,2444,4033,158,258,416,0.969273211,138288,162114,300402,1865,2957,4822,1,4,141229,544,168696,309925
Not considered,Below average state,ASSAM,Total,0,UP,ASSAM,18,B0101,Urban,Underperformance,0.312855487,221640,1154468,1376108,43254,67211,110465,83802,111309,195111,12257,17931,30188,0.635923222,1820389,976746,2797135,312221,181407,493628,1,4,2138088,516,2260454,4398542
Not considered,Below average state,CHANDIGARH,Total,0,UP,CHANDIGARH,4,B0101,Urban,Underperformance,0.364599073,67412,306834,374246,2807,5106,7913,5870,8848,14718,1009,1813,2822,0.618313055,388655,246018,634673,28317,19289,47606,1,4,462946,538,563513,1026459
Not considered,Below average state,DADRA & NAGAR HAVELI,Total,0,UP,DADRA & NAGAR HAVELI,26,B0101,Urban,Underperformance,0.423973349,7202,60886,68088,333,487,820,2160,2249,4409,186,355,541,0.545203773,55592,31965,87557,2267,1078,3345,1,4,65140,523,95455,160595
Not considered,Below average state,DELHI,Total,0,UP,DELHI,7,B0101,Urban,Underperformance,0.316992548,729677,4459142,5188819,26770,86654,113424,65148,160503,225651,11471,30881,42352,0.666634757,6801598,4110479,10912077,298065,313533,611598,1,4,7607894,500,8761005,16368899
Not considered,Below average state,GOA,Total,0,UP,GOA,30,B0101,Urban,Underperformance,0.34354785,76609,234925,311534,7926,13220,21146,15706,26183,41889,2847,5442,8289,0.60111776,347948,197154,545102,41149,23722,64871,1,4,443110,535,463704,906814
Not considered,Below average state,JAMMU & KASHMIR,Total,0,UP,JAMMU & KASHMIR,1,B0101,Urban,Underperformance,0.283794443,121704,852631,974335,51613,76172,127785,78863,108755,187618,25981,21698,47679,0.647670627,1340509,883101,2223610,242098,157600,399698,1,4,1567057,524,1866185,3433242
Not considered,Below average state,JHARKHAND,Total,0,UP,JHARKHAND,20,B0101,Urban,Underperformance,0.243506888,260735,1671020,1931755,54328,170655,224983,93903,229122,323025,25857,40485,66342,0.707411553,3398737,2213202,5611939,286026,298336,584362,1,4,3779232,529,4153829,7933061
Not considered,Below average state,KERALA,Total,0,UP,KERALA,32,B0101,Urban,Underperformance,0.276095164,962806,3436750,4399556,182222,253878,436100,284624,426550,711174,85608,80768,166376,0.668833981,6982530,3675290,10657820,1316764,547950,1864714,1,4,8315568,539,7619358,15934926
Not considered,Below average state,LAKSHADWEEP,Total,0,UP,LAKSHADWEEP,31,B0101,Urban,Underperformance,0.170448224,1320,7259,8579,987,3100,4087,719,2722,3441,530,1550,2080,0.719860129,21883,14349,36232,5595,4493,10088,1,4,24452,528,25880,50332
Not considered,Below average state,MADHYA PRADESH,Total,0,UP,MADHYA PRADESH,23,B0101,Urban,Underperformance,0.29759532,1098679,4873882,5972561,150756,307232,457988,294661,451323,745984,60602,79788,140390,0.658239245,8152545,5057925,13210470,593416,497196,1090612,1,3,9606487,554,10462918,20069405
Not considered,Below average state,MANIPUR,Total,0,UP,MANIPUR,14,B0101,Urban,Underperformance,0.312509441,88028,172653,260681,20636,16771,37407,40874,26784,67658,11224,5886,17110,0.585869036,282326,206379,488705,47328,34961,82289,1,3,422452,551,411702,834154
Not considered,Below average state,NAGALAND,Total,0,UP,NAGALAND,13,B0101,Urban,Underperformance,0.303879741,47685,125820,173505,6848,7113,13961,17244,13416,30660,5388,4209,9597,0.625613434,201472,155732,357204,25718,21805,47523,1,3,271789,567,299177,570966
Not considered,Below average state,ODISHA,Total,0,UP,ODISHA,21,B0101,Urban,Underperformance,0.297501191,335174,1748422,2083596,54316,111131,165447,119015,183871,302886,22605,28788,51393,0.651913943,2900929,1664852,4565781,283480,256066,539546,1,3,3377723,558,3625933,7003656
Not considered,Below average state,PUDUCHERRY,Total,0,UP,PUDUCHERRY,34,B0101,Urban,Underperformance,0.325417794,62160,215341,277501,2798,4696,7494,6156,9705,15861,1550,2180,3730,0.651608379,365283,190378,555661,29877,16685,46562,1,4,435149,493,417604,852753
Not considered,Below average state,PUNJAB,Total,0,UP,PUNJAB,3,B0101,Urban,Underperformance,0.321556405,497120,2846792,3343912,54793,105438,160231,127515,200302,327817,15190,31244,46434,0.642454967,4213332,2467651,6680983,329307,240807,570114,1,3,4853157,556,5545989,10399146
Not considered,Below average state,UTTAR PRADESH,Total,0,UP,UTTAR PRADESH,9,B0101,Urban,Underperformance,0.249391152,1488723,9607952,11096675,310289,933243,1243532,768250,1625031,2393281,112879,260900,373779,0.688420825,18637696,11993632,30631328,1222389,1287318,2509707,1,4,21007548,507,23487515,44495063
Not considered,Below average state,UTTARAKHAND,Total,0,UP,UTTARAKHAND,5,B0101,Urban,Underperformance,0.286387406,125055,748237,873292,13815,40560,54375,31231,66778,98009,5209,10232,15441,0.676407797,1269112,793484,2062596,88188,77180,165368,1,4,1430607,544,1618731,3049338
States needing Special Attention,Below average state,BIHAR,15-19,0,UP,BIHAR,10,B0101,Urban,Underperformance,0.084774518,17636,86549,104185,11423,31373,42796,17781,40436,58217,2964,7079,10043,0.859682855,522502,534019,1056521,74321,117744,192065,1,4,560883,446,668083,1228966
States needing Special Attention,Below average state,HARYANA,15-19,0,UP,HARYANA,6,B0101,Urban,Underperformance,0.092318318,12640,68360,81000,4170,12610,16780,8101,18582,26683,1139,3892,5031,0.871536211,362362,402323,764685,31376,55006,86382,1,4,384242,505,493157,877399
States needing Special Attention,Below average state,BIHAR,15-59,0,UP,BIHAR,10,B0101,Urban,Underperformance,0.340410151,307674,2023260,2330934,83586,264727,348313,155672,370782,526454,30384,56521,86905,0.570014756,2733593,1169542,3903135,365596,379014,744610,1,4,3227323,446,3620105,6847428
States needing Special Attention,Below average state,HARYANA,15-59,0,UP,HARYANA,6,B0101,Urban,Underperformance,0.4193948,365570,2031689,2397259,38672,107593,146265,76921,164369,241290,14169,33019,47188,0.530136655,2230610,799649,3030259,221653,177531,399184,1,4,2687270,505,3028726,5715996
States needing Special Attention,Below average state,BIHAR,20-24,0,UP,BIHAR,10,B0101,Urban,Underperformance,0.209307932,29945,190599,220544,14618,47198,61816,23121,58909,82030,3972,9018,12990,0.700513058,430588,307530,738118,89037,124857,213894,1,4,487626,446,566056,1053682
States needing Special Attention,Below average state,HARYANA,20-24,0,UP,HARYANA,6,B0101,Urban,Underperformance,0.287854533,37107,224526,261633,7760,23413,31173,12637,31340,43977,2086,6579,8665,0.65422755,373855,220777,594632,64090,71120,135210,1,4,425685,505,483222,908907
States needing Special Attention,Below average state,BIHAR,25-29,0,UP,BIHAR,10,B0101,Urban,Underperformance,0.334556704,42476,275024,317500,13890,45317,59207,23951,59387,83338,4462,9050,13512,0.563390329,389603,145064,534667,69096,69616,138712,1,4,460492,446,488525,949017
States needing Special Attention,Below average state,HARYANA,25-29,0,UP,HARYANA,6,B0101,Urban,Underperformance,0.475389221,62660,340336,402996,6922,19969,26891,12309,29148,41457,2182,5781,7963,0.46631309,329956,65346,395302,50088,27805,77893,1,4,407107,505,440611,847718
States needing Special Attention,Below average state,BIHAR,30-34,0,UP,BIHAR,10,B0101,Urban,Underperformance,0.414625193,45503,308045,353548,12019,39274,51293,22241,54055,76296,4526,7933,12459,0.481286934,344233,66157,410390,46007,31317,77324,1,4,416503,446,436190,852693
States needing Special Attention,Below average state,HARYANA,30-34,0,UP,HARYANA,6,B0101,Urban,Underperformance,0.527154218,59363,319867,379230,5622,14669,20291,11008,22244,33252,2114,4426,6540,0.417532329,275471,24898,300369,28833,9007,37840,1,4,347956,505,371435,719391
States needing Special Attention,Below average state,BIHAR,35-39,0,UP,BIHAR,10,B0101,Urban,Underperformance,0.457583237,47433,312232,359665,10739,34464,45203,20844,48729,69573,4303,7224,11527,0.439237414,307634,37611,345245,36124,15788,51912,1,4,380214,446,405796,786010
States needing Special Attention,Below average state,HARYANA,35-39,0,UP,HARYANA,6,B0101,Urban,Underperformance,0.545422657,59162,303135,362297,5179,12686,17865,10521,19521,30042,2181,3895,6076,0.400203237,249179,16656,265835,20629,4683,25312,1,4,321043,505,343207,664250
States needing Special Attention,Below average state,BIHAR,40-49,0,UP,BIHAR,10,B0101,Urban,Underperformance,0.494217245,77135,517737,594872,13981,45382,59363,30182,70229,100411,6236,10329,16565,0.408599569,446684,45133,491817,36664,14069,50733,1,4,560237,446,643428,1203665
States needing Special Attention,Below average state,HARYANA,40-49,0,UP,HARYANA,6,B0101,Urban,Underperformance,0.55158059,86643,484431,571074,6348,16776,23124,14734,28535,43269,2955,5479,8434,0.398481273,383973,28591,412564,19593,5951,25544,1,4,488305,505,547036,1035341
States needing Special Attention,Below average state,BIHAR,5-Sep,0,UP,BIHAR,10,B0101,Urban,Underperformance,0.009490023,5642,7696,13338,2629,3291,5920,7226,8412,15638,612,728,1340,0.978430083,653600,721560,1375160,6708,8261,14969,1,4,667080,446,738396,1405476
States needing Special Attention,Below average state,HARYANA,5-Sep,0,UP,HARYANA,6,B0101,Urban,Underperformance,0.007901084,2658,3812,6470,885,1252,2137,3784,4786,8570,99,120,219,0.981365898,360981,442635,803616,2671,3584,6255,1,4,367522,505,451353,818875
States needing Special Attention,Below average state,BIHAR,50-59,0,UP,BIHAR,10,B0101,Urban,Underperformance,0.49214179,47546,333074,380620,6916,21719,28635,17552,39037,56589,3921,5888,9809,0.422005573,292349,34028,326377,14347,5623,19970,1,4,361368,446,412027,773395
States needing Special Attention,Below average state,HARYANA,50-59,0,UP,HARYANA,6,B0101,Urban,Underperformance,0.511363671,47995,291034,339029,2671,7470,10141,7611,14999,22610,1512,2967,4479,0.447777493,255814,41058,296872,7044,3959,11003,1,4,312932,505,350058,662990
States needing Special Attention,Below average state,BIHAR,60-69,0,UP,BIHAR,10,B0101,Urban,Underperformance,0.337670772,22452,163169,185621,4015,13300,17315,10852,27188,38040,2851,5035,7886,0.578783358,222196,95967,318163,7783,5679,13462,1,4,258351,446,291359,549710
States needing Special Attention,Below average state,HARYANA,60-69,0,UP,HARYANA,6,B0101,Urban,Underperformance,0.276485614,13596,105681,119277,1284,4225,5509,4167,9391,13558,919,2243,3162,0.684757211,191869,103538,295407,3395,3770,7165,1,4,210551,505,220853,431404
States needing Special Attention,Below average state,BIHAR,60+,0,UP,BIHAR,10,B0101,Urban,Underperformance,0.301592807,29822,223202,253024,5314,17813,23127,14682,38624,53306,3765,7406,11171,0.621553616,341548,179910,521458,10091,8044,18135,1,4,389817,446,449142,838959
States needing Special Attention,Below average state,HARYANA,60+,0,UP,HARYANA,6,B0101,Urban,Underperformance,0.232836514,18456,140074,158530,1657,5375,7032,5747,12876,18623,1227,3044,4271,0.733538563,311878,187562,499440,4594,4925,9519,1,4,337308,505,343556,680864
States needing Special Attention,Below average state,BIHAR,70-79,0,UP,BIHAR,10,B0101,Urban,Underperformance,0.250577411,5596,47348,52944,943,3484,4427,2808,8815,11623,704,1875,2579,0.682206278,84136,60006,144142,1669,1673,3342,1,4,93244,446,118044,211288
States needing Special Attention,Below average state,HARYANA,70-79,0,UP,HARYANA,6,B0101,Urban,Underperformance,0.169689508,3405,25954,29359,256,835,1091,1089,2567,3656,231,591,822,0.804428492,81170,58009,139179,810,821,1631,1,4,85895,505,87121,173016
States needing Special Attention,Below average state,BIHAR,80+,0,UP,BIHAR,10,B0101,Urban,Underperformance,0.185464527,1774,12685,14459,356,1029,1385,1022,2621,3643,210,496,706,0.75875117,35216,23937,59153,639,692,1331,1,4,38222,446,39739,77961
States needing Special Attention,Below average state,HARYANA,80+,0,UP,HARYANA,6,B0101,Urban,Underperformance,0.129428078,1455,8439,9894,117,315,432,491,918,1409,77,210,287,0.848385746,38839,26015,64854,389,334,723,1,4,40862,505,35582,76444
States needing Special Attention,Below average state,BIHAR,Age not stated,0,UP,BIHAR,10,B0101,Urban,Underperformance,0.209574683,1879,9538,11417,776,1387,2163,1762,2701,4463,151,237,388,0.701378563,20923,17286,38209,953,1158,2111,1,4,24715,446,29762,54477
States needing Special Attention,Below average state,HARYANA,Age not stated,0,UP,HARYANA,6,B0101,Urban,Underperformance,0.257189811,593,2224,2817,65,134,199,160,305,465,19,34,53,0.69551721,4304,3314,7618,180,163,343,1,4,5076,505,5877,10953
States needing Special Attention,Below average state,BIHAR,Oct-14,0,UP,BIHAR,10,B0101,Urban,Underperformance,0.018613137,8018,18914,26932,4689,7993,12682,10701,14999,25700,1726,2484,4210,0.960715582,666634,723459,1390093,14391,20915,35306,1,4,687079,446,759856,1446935
States needing Special Attention,Below average state,HARYANA,Oct-14,0,UP,HARYANA,6,B0101,Urban,Underperformance,0.016828325,4189,10213,14402,1405,2532,3937,4989,7148,12137,393,709,1102,0.967702283,368198,459980,828178,4897,7887,12784,1,4,377769,505,478050,855819
States needing Special Attention,Below average state,BIHAR,Total,0,UP,BIHAR,10,B0101,Urban,Underperformance,0.22415729,353035,2282610,2635645,96994,295211,392205,190043,435518,625561,36638,67376,104014,0.713793552,4973993,3418803,8392796,397739,417392,815131,1,4,5553709,446,6204307,11758016
States needing Special Attention,Below average state,HARYANA,Total,0,UP,HARYANA,6,B0101,Urban,Underperformance,0.291726753,391466,2188012,2579478,42684,116886,159570,91601,189484,281085,15907,36926,52833,0.670508701,3622401,2306306,5928707,233995,194090,428085,1,4,4121375,505,4720728,8842103
